year,country,soe,arrivals,arrivals_male,arrivals_female
2020,ABW,Kedah,0,0,0
2020,ABW,Pulau Pinang,0,0,0
2020,AFG,Johor,7,4,3
2020,AFG,Kedah,4,4,0
2020,AFG,Perlis,0,0,0
2020,AFG,Pulau Pinang,0,0,0
2020,AFG,Sarawak,0,0,0
2020,AFG,Selangor,553,443,110
2020,AGO,Johor,0,0,0
2020,AGO,Kedah,0,0,0
2020,AGO,Sabah,0,0,0
2020,AGO,Selangor,18,12,6
2020,AIA,Selangor,0,0,0
2020,ALB,Johor,71,39,32
2020,ALB,Kedah,6,4,2
2020,ALB,Perak,1,1,0
2020,ALB,Perlis,1,1,0
2020,ALB,Pulau Pinang,3,1,2
2020,ALB,Sabah,1,1,0
2020,ALB,Sarawak,1,1,0
2020,ALB,Selangor,113,58,55
2020,AND,Johor,0,0,0
2020,AND,Kedah,0,0,0
2020,AND,Perlis,0,0,0
2020,AND,Pulau Pinang,0,0,0
2020,AND,Selangor,15,9,6
2020,ANT,Selangor,0,0,0
2020,ARE,Johor,33,23,10
2020,ARE,Kedah,9,6,3
2020,ARE,Kelantan,0,0,0
2020,ARE,Perak,0,0,0
2020,ARE,Perlis,0,0,0
2020,ARE,Pulau Pinang,6,3,3
2020,ARE,Sabah,1,1,0
2020,ARE,Sarawak,1,1,0
2020,ARE,Selangor,701,491,210
2020,ARG,Johor,365,202,163
2020,ARG,Kedah,525,261,264
2020,ARG,Kelantan,8,3,5
2020,ARG,Melaka,0,0,0
2020,ARG,Perak,0,0,0
2020,ARG,Perlis,38,18,20
2020,ARG,Pulau Pinang,18,8,10
2020,ARG,Sabah,16,9,7
2020,ARG,Sarawak,9,7,2
2020,ARG,Selangor,1843,978,865
2020,ARG,W.P. Labuan,1,1,0
2020,ARM,Johor,15,6,9
2020,ARM,Kedah,6,3,3
2020,ARM,Kelantan,1,1,0
2020,ARM,Perak,2,0,2
2020,ARM,Perlis,0,0,0
2020,ARM,Pulau Pinang,2,2,0
2020,ARM,Sabah,0,0,0
2020,ARM,Sarawak,0,0,0
2020,ARM,Selangor,158,65,93
2020,ATA,Selangor,1,0,1
2020,ATG,Johor,7,4,3
2020,ATG,Kedah,0,0,0
2020,ATG,Pulau Pinang,0,0,0
2020,ATG,Sarawak,0,0,0
2020,ATG,Selangor,42,26,16
2020,AUS,Johor,13730,8106,5624
2020,AUS,Kedah,1862,1056,806
2020,AUS,Kelantan,53,29,24
2020,AUS,Melaka,14,10,4
2020,AUS,Negeri Sembilan,1,1,0
2020,AUS,Pahang,75,35,40
2020,AUS,Perak,451,252,199
2020,AUS,Perlis,211,126,85
2020,AUS,Pulau Pinang,4486,2366,2120
2020,AUS,Sabah,1473,722,751
2020,AUS,Sarawak,1528,904,624
2020,AUS,Selangor,61218,35884,25334
2020,AUS,Terengganu,2,2,0
2020,AUS,W.P. Labuan,44,30,14
2020,AUT,Johor,536,362,174
2020,AUT,Kedah,390,222,168
2020,AUT,Kelantan,26,23,3
2020,AUT,Melaka,1,1,0
2020,AUT,Negeri Sembilan,0,0,0
2020,AUT,Pahang,0,0,0
2020,AUT,Perak,22,16,6
2020,AUT,Perlis,66,41,25
2020,AUT,Pulau Pinang,171,115,56
2020,AUT,Sabah,56,31,25
2020,AUT,Sarawak,38,27,11
2020,AUT,Selangor,2468,1522,946
2020,AUT,Terengganu,0,0,0
2020,AUT,W.P. Labuan,2,1,1
2020,AZE,Johor,10,7,3
2020,AZE,Kedah,15,11,4
2020,AZE,Kelantan,0,0,0
2020,AZE,Melaka,2,1,1
2020,AZE,Perlis,0,0,0
2020,AZE,Pulau Pinang,0,0,0
2020,AZE,Sabah,3,2,1
2020,AZE,Sarawak,4,1,3
2020,AZE,Selangor,287,172,115
2020,AZE,W.P. Labuan,1,1,0
2020,BDI,Pulau Pinang,0,0,0
2020,BDI,Sarawak,0,0,0
2020,BDI,Selangor,4,3,1
2020,BEL,Johor,631,430,201
2020,BEL,Kedah,370,201,169
2020,BEL,Kelantan,19,13,6
2020,BEL,Melaka,1,1,0
2020,BEL,Negeri Sembilan,2,1,1
2020,BEL,Pahang,5,2,3
2020,BEL,Perak,10,7,3
2020,BEL,Perlis,53,32,21
2020,BEL,Pulau Pinang,169,111,58
2020,BEL,Sabah,56,37,19
2020,BEL,Sarawak,46,25,21
2020,BEL,Selangor,3122,2065,1057
2020,BEL,W.P. Labuan,7,5,2
2020,BEN,Johor,3,1,2
2020,BEN,Kedah,0,0,0
2020,BEN,Perak,0,0,0
2020,BEN,Pulau Pinang,0,0,0
2020,BEN,Sabah,1,1,0
2020,BEN,Sarawak,0,0,0
2020,BEN,Selangor,12,8,4
2020,BFA,Perak,0,0,0
2020,BFA,Pulau Pinang,0,0,0
2020,BFA,Selangor,13,13,0
2020,BGD,Johor,7864,7036,828
2020,BGD,Kedah,83,41,42
2020,BGD,Kelantan,2,1,1
2020,BGD,Melaka,17,17,0
2020,BGD,Negeri Sembilan,0,0,0
2020,BGD,Pahang,1,1,0
2020,BGD,Perak,0,0,0
2020,BGD,Perlis,0,0,0
2020,BGD,Pulau Pinang,222,205,17
2020,BGD,Sabah,24,17,7
2020,BGD,Sarawak,379,339,40
2020,BGD,Selangor,49038,42927,6111
2020,BGD,W.P. Labuan,40,40,0
2020,BGR,Johor,138,96,42
2020,BGR,Kedah,146,75,71
2020,BGR,Kelantan,0,0,0
2020,BGR,Pahang,4,4,0
2020,BGR,Perak,4,4,0
2020,BGR,Perlis,2,2,0
2020,BGR,Pulau Pinang,11,7,4
2020,BGR,Sabah,6,3,3
2020,BGR,Sarawak,2,2,0
2020,BGR,Selangor,1082,622,460
2020,BGR,W.P. Labuan,2,1,1
2020,BHR,Johor,24,12,12
2020,BHR,Kedah,6,4,2
2020,BHR,Kelantan,1,1,0
2020,BHR,Perlis,0,0,0
2020,BHR,Pulau Pinang,0,0,0
2020,BHR,Sabah,1,1,0
2020,BHR,Sarawak,9,9,0
2020,BHR,Selangor,554,328,226
2020,BHS,Johor,2,1,1
2020,BHS,Kedah,0,0,0
2020,BHS,Perak,0,0,0
2020,BHS,Sabah,2,1,1
2020,BHS,Sarawak,0,0,0
2020,BHS,Selangor,10,6,4
2020,BIH,Johor,15,8,7
2020,BIH,Kedah,17,8,9
2020,BIH,Perlis,2,2,0
2020,BIH,Pulau Pinang,8,6,2
2020,BIH,Sabah,0,0,0
2020,BIH,Sarawak,2,2,0
2020,BIH,Selangor,195,110,85
2020,BLR,Johor,39,19,20
2020,BLR,Kedah,90,41,49
2020,BLR,Kelantan,5,2,3
2020,BLR,Pahang,0,0,0
2020,BLR,Perak,0,0,0
2020,BLR,Perlis,5,3,2
2020,BLR,Pulau Pinang,18,8,10
2020,BLR,Sabah,12,9,3
2020,BLR,Sarawak,9,2,7
2020,BLR,Selangor,1080,495,585
2020,BLR,W.P. Labuan,1,0,1
2020,BLZ,Johor,4,2,2
2020,BLZ,Pulau Pinang,0,0,0
2020,BLZ,Sarawak,0,0,0
2020,BLZ,Selangor,17,10,7
2020,BMU,Selangor,0,0,0
2020,BOL,Johor,7,3,4
2020,BOL,Kedah,2,0,2
2020,BOL,Melaka,0,0,0
2020,BOL,Perak,2,0,2
2020,BOL,Perlis,0,0,0
2020,BOL,Pulau Pinang,0,0,0
2020,BOL,Sabah,0,0,0
2020,BOL,Sarawak,0,0,0
2020,BOL,Selangor,63,34,29
2020,BRA,Johor,518,300,218
2020,BRA,Kedah,291,139,152
2020,BRA,Kelantan,1,0,1
2020,BRA,Melaka,0,0,0
2020,BRA,Pahang,0,0,0
2020,BRA,Perak,11,7,4
2020,BRA,Perlis,22,8,14
2020,BRA,Pulau Pinang,58,34,24
2020,BRA,Sabah,33,18,15
2020,BRA,Sarawak,31,12,19
2020,BRA,Selangor,3179,1800,1379
2020,BRA,W.P. Labuan,0,0,0
2020,BRB,Johor,4,2,2
2020,BRB,Kedah,0,0,0
2020,BRB,Perlis,0,0,0
2020,BRB,Pulau Pinang,0,0,0
2020,BRB,Selangor,17,4,13
2020,BRN,Johor,723,335,388
2020,BRN,Kedah,25,16,9
2020,BRN,Kelantan,18,10,8
2020,BRN,Melaka,0,0,0
2020,BRN,Pahang,0,0,0
2020,BRN,Perak,4,3,1
2020,BRN,Perlis,19,10,9
2020,BRN,Pulau Pinang,16,9,7
2020,BRN,Sabah,1715,891,824
2020,BRN,Sarawak,168656,99408,69248
2020,BRN,Selangor,11695,5912,5783
2020,BRN,W.P. Labuan,4917,3227,1690
2020,BTN,Johor,16,12,4
2020,BTN,Kedah,4,4,0
2020,BTN,Perak,0,0,0
2020,BTN,Perlis,0,0,0
2020,BTN,Pulau Pinang,4,1,3
2020,BTN,Sabah,0,0,0
2020,BTN,Sarawak,1,1,0
2020,BTN,Selangor,109,74,35
2020,BWA,Johor,7,2,5
2020,BWA,Kedah,0,0,0
2020,BWA,Perlis,0,0,0
2020,BWA,Pulau Pinang,0,0,0
2020,BWA,Sabah,0,0,0
2020,BWA,Sarawak,2,2,0
2020,BWA,Selangor,46,21,25
2020,CAF,Kedah,0,0,0
2020,CAF,Selangor,1,1,0
2020,CAN,Johor,3609,2094,1515
2020,CAN,Kedah,738,423,315
2020,CAN,Kelantan,43,27,16
2020,CAN,Melaka,2,1,1
2020,CAN,Negeri Sembilan,0,0,0
2020,CAN,Pahang,4,3,1
2020,CAN,Perak,61,38,23
2020,CAN,Perlis,178,112,66
2020,CAN,Pulau Pinang,1065,604,461
2020,CAN,Sabah,520,279,241
2020,CAN,Sarawak,1061,622,439
2020,CAN,Selangor,12259,7186,5073
2020,CAN,Terengganu,0,0,0
2020,CAN,W.P. Labuan,34,24,10
2020,CCK,Selangor,0,0,0
2020,CHE,Johor,1004,610,394
2020,CHE,Kedah,701,369,332
2020,CHE,Kelantan,24,13,11
2020,CHE,Melaka,3,2,1
2020,CHE,Negeri Sembilan,0,0,0
2020,CHE,Pahang,5,3,2
2020,CHE,Perak,34,21,13
2020,CHE,Perlis,139,88,51
2020,CHE,Pulau Pinang,352,213,139
2020,CHE,Sabah,119,61,58
2020,CHE,Sarawak,103,53,50
2020,CHE,Selangor,3545,2190,1355
2020,CHE,W.P. Labuan,14,11,3
2020,CHL,Johor,108,56,52
2020,CHL,Kedah,138,69,69
2020,CHL,Kelantan,5,2,3
2020,CHL,Melaka,0,0,0
2020,CHL,Pahang,0,0,0
2020,CHL,Perak,1,1,0
2020,CHL,Perlis,15,6,9
2020,CHL,Pulau Pinang,31,11,20
2020,CHL,Sabah,9,3,6
2020,CHL,Sarawak,3,2,1
2020,CHL,Selangor,1008,494,514
2020,CHN,Johor,106340,44176,62164
2020,CHN,Kedah,6050,2578,3472
2020,CHN,Kelantan,46,24,22
2020,CHN,Melaka,8,3,5
2020,CHN,Pahang,51,24,27
2020,CHN,Perak,688,251,437
2020,CHN,Perlis,292,143,149
2020,CHN,Pulau Pinang,14438,7044,7394
2020,CHN,Sabah,13459,6131,7328
2020,CHN,Sarawak,2314,1039,1275
2020,CHN,Selangor,251044,127992,123052
2020,CHN,Terengganu,0,0,0
2020,CHN,W.P. Labuan,83,40,43
2020,CIV,Johor,0,0,0
2020,CIV,Kedah,1,1,0
2020,CIV,Pulau Pinang,1,1,0
2020,CIV,Sabah,0,0,0
2020,CIV,Sarawak,0,0,0
2020,CIV,Selangor,57,42,15
2020,CMR,Johor,8,8,0
2020,CMR,Kedah,0,0,0
2020,CMR,Pulau Pinang,2,0,2
2020,CMR,Sabah,1,1,0
2020,CMR,Sarawak,3,3,0
2020,CMR,Selangor,69,45,24
2020,COD,Johor,0,0,0
2020,COD,Pulau Pinang,1,1,0
2020,COD,Sarawak,0,0,0
2020,COD,Selangor,31,19,12
2020,COG,Johor,1,1,0
2020,COG,Kedah,1,0,1
2020,COG,Selangor,5,3,2
2020,COK,Selangor,0,0,0
2020,COL,Johor,38,23,15
2020,COL,Kedah,3,1,2
2020,COL,Perak,0,0,0
2020,COL,Pulau Pinang,6,4,2
2020,COL,Sabah,4,3,1
2020,COL,Sarawak,1,0,1
2020,COL,Selangor,402,203,199
2020,COL,W.P. Labuan,0,0,0
2020,COM,Johor,0,0,0
2020,COM,Kedah,1,0,1
2020,COM,Selangor,48,34,14
2020,CPV,Johor,3,2,1
2020,CPV,Kedah,0,0,0
2020,CPV,Pulau Pinang,0,0,0
2020,CPV,Sabah,0,0,0
2020,CPV,Selangor,8,6,2
2020,CRI,Johor,21,15,6
2020,CRI,Kedah,3,2,1
2020,CRI,Perak,1,0,1
2020,CRI,Perlis,0,0,0
2020,CRI,Pulau Pinang,4,1,3
2020,CRI,Sabah,1,0,1
2020,CRI,Sarawak,0,0,0
2020,CRI,Selangor,162,102,60
2020,CUB,Johor,15,15,0
2020,CUB,Kedah,1,1,0
2020,CUB,Perlis,0,0,0
2020,CUB,Pulau Pinang,1,1,0
2020,CUB,Sabah,0,0,0
2020,CUB,Sarawak,0,0,0
2020,CUB,Selangor,80,43,37
2020,CYP,Johor,30,18,12
2020,CYP,Kedah,7,3,4
2020,CYP,Perak,0,0,0
2020,CYP,Perlis,0,0,0
2020,CYP,Pulau Pinang,7,3,4
2020,CYP,Sabah,3,2,1
2020,CYP,Sarawak,1,0,1
2020,CYP,Selangor,139,86,53
2020,CZE,Johor,524,294,230
2020,CZE,Kedah,1300,649,651
2020,CZE,Kelantan,8,7,1
2020,CZE,Melaka,2,2,0
2020,CZE,Negeri Sembilan,0,0,0
2020,CZE,Perak,0,0,0
2020,CZE,Perlis,39,25,14
2020,CZE,Pulau Pinang,208,97,111
2020,CZE,Sabah,103,54,49
2020,CZE,Sarawak,86,50,36
2020,CZE,Selangor,2491,1432,1059
2020,CZE,W.P. Labuan,13,9,4
2020,DEU,Johor,5424,3488,1936
2020,DEU,Kedah,3425,1769,1656
2020,DEU,Kelantan,111,78,33
2020,DEU,Melaka,8,4,4
2020,DEU,Negeri Sembilan,1,1,0
2020,DEU,Pahang,19,12,7
2020,DEU,Perak,123,83,40
2020,DEU,Perlis,592,361,231
2020,DEU,Pulau Pinang,1432,958,474
2020,DEU,Sabah,504,298,206
2020,DEU,Sarawak,673,420,253
2020,DEU,Selangor,18766,11608,7158
2020,DEU,Terengganu,0,0,0
2020,DEU,W.P. Labuan,59,44,15
2020,DJI,Johor,0,0,0
2020,DJI,Selangor,39,20,19
2020,DMA,Johor,14,11,3
2020,DMA,Kedah,0,0,0
2020,DMA,Pulau Pinang,1,1,0
2020,DMA,Sabah,6,5,1
2020,DMA,Sarawak,1,1,0
2020,DMA,Selangor,94,76,18
2020,DMA,W.P. Labuan,1,1,0
2020,DNK,Johor,827,545,282
2020,DNK,Kedah,1024,472,552
2020,DNK,Kelantan,4,3,1
2020,DNK,Melaka,3,3,0
2020,DNK,Negeri Sembilan,0,0,0
2020,DNK,Pahang,0,0,0
2020,DNK,Perak,22,13,9
2020,DNK,Perlis,47,32,15
2020,DNK,Pulau Pinang,382,203,179
2020,DNK,Sabah,196,113,83
2020,DNK,Sarawak,76,43,33
2020,DNK,Selangor,4222,2495,1727
2020,DNK,W.P. Labuan,8,5,3
2020,DOM,Johor,5,3,2
2020,DOM,Kedah,0,0,0
2020,DOM,Perak,0,0,0
2020,DOM,Perlis,1,1,0
2020,DOM,Pulau Pinang,1,1,0
2020,DOM,Sabah,1,1,0
2020,DOM,Sarawak,1,1,0
2020,DOM,Selangor,56,34,22
2020,DZA,Johor,74,69,5
2020,DZA,Kedah,53,36,17
2020,DZA,Kelantan,0,0,0
2020,DZA,Melaka,0,0,0
2020,DZA,Perak,0,0,0
2020,DZA,Perlis,5,2,3
2020,DZA,Pulau Pinang,26,17,9
2020,DZA,Sabah,1,1,0
2020,DZA,Sarawak,12,5,7
2020,DZA,Selangor,1921,1387,534
2020,DZA,W.P. Labuan,0,0,0
2020,ECU,Johor,35,16,19
2020,ECU,Kedah,4,1,3
2020,ECU,Perak,0,0,0
2020,ECU,Perlis,0,0,0
2020,ECU,Pulau Pinang,0,0,0
2020,ECU,Sabah,0,0,0
2020,ECU,Sarawak,8,1,7
2020,ECU,Selangor,159,79,80
2020,EGY,Johor,534,440,94
2020,EGY,Kedah,52,25,27
2020,EGY,Kelantan,12,12,0
2020,EGY,Melaka,0,0,0
2020,EGY,Pahang,0,0,0
2020,EGY,Perak,0,0,0
2020,EGY,Perlis,2,2,0
2020,EGY,Pulau Pinang,23,18,5
2020,EGY,Sabah,12,8,4
2020,EGY,Sarawak,139,98,41
2020,EGY,Selangor,6171,4085,2086
2020,EGY,Terengganu,0,0,0
2020,EGY,W.P. Labuan,6,6,0
2020,ERI,Johor,0,0,0
2020,ERI,Pulau Pinang,0,0,0
2020,ERI,Sabah,2,1,1
2020,ERI,Selangor,63,43,20
2020,ESP,Johor,980,607,373
2020,ESP,Kedah,726,350,376
2020,ESP,Kelantan,23,16,7
2020,ESP,Melaka,4,3,1
2020,ESP,Negeri Sembilan,0,0,0
2020,ESP,Pahang,2,2,0
2020,ESP,Perak,12,8,4
2020,ESP,Perlis,88,51,37
2020,ESP,Pulau Pinang,174,103,71
2020,ESP,Sabah,124,72,52
2020,ESP,Sarawak,105,55,50
2020,ESP,Selangor,5358,3228,2130
2020,ESP,W.P. Labuan,16,10,6
2020,EST,Johor,174,84,90
2020,EST,Kedah,287,139,148
2020,EST,Kelantan,1,0,1
2020,EST,Pahang,0,0,0
2020,EST,Perak,3,2,1
2020,EST,Perlis,4,3,1
2020,EST,Pulau Pinang,16,9,7
2020,EST,Sabah,23,12,11
2020,EST,Sarawak,16,7,9
2020,EST,Selangor,889,456,433
2020,EST,W.P. Labuan,2,1,1
2020,ETH,Johor,7,6,1
2020,ETH,Kedah,0,0,0
2020,ETH,Pulau Pinang,0,0,0
2020,ETH,Sarawak,2,0,2
2020,ETH,Selangor,100,63,37
2020,FIN,Johor,682,422,260
2020,FIN,Kedah,1115,500,615
2020,FIN,Kelantan,10,5,5
2020,FIN,Melaka,2,1,1
2020,FIN,Negeri Sembilan,0,0,0
2020,FIN,Pahang,0,0,0
2020,FIN,Perak,6,4,2
2020,FIN,Perlis,38,25,13
2020,FIN,Pulau Pinang,307,174,133
2020,FIN,Sabah,77,42,35
2020,FIN,Sarawak,41,22,19
2020,FIN,Selangor,3468,1871,1597
2020,FIN,W.P. Labuan,7,4,3
2020,FJI,Johor,104,52,52
2020,FJI,Kedah,7,2,5
2020,FJI,Kelantan,0,0,0
2020,FJI,Perak,0,0,0
2020,FJI,Perlis,4,0,4
2020,FJI,Pulau Pinang,4,4,0
2020,FJI,Sabah,1,0,1
2020,FJI,Sarawak,2,2,0
2020,FJI,Selangor,263,150,113
2020,FRA,Johor,4827,2976,1851
2020,FRA,Kedah,3239,1789,1450
2020,FRA,Kelantan,194,132,62
2020,FRA,Melaka,7,6,1
2020,FRA,Negeri Sembilan,2,2,0
2020,FRA,Pahang,65,33,32
2020,FRA,Perak,60,42,18
2020,FRA,Perlis,332,205,127
2020,FRA,Pulau Pinang,1292,769,523
2020,FRA,Sabah,369,220,149
2020,FRA,Sarawak,286,191,95
2020,FRA,Selangor,23249,14105,9144
2020,FRA,Terengganu,0,0,0
2020,FRA,W.P. Labuan,17,13,4
2020,FSM,Johor,1,1,0
2020,FSM,Pulau Pinang,1,0,1
2020,FSM,Selangor,1,1,0
2020,GAB,Johor,1,1,0
2020,GAB,Pulau Pinang,0,0,0
2020,GAB,Sarawak,0,0,0
2020,GAB,Selangor,15,9,6
2020,GBR,Johor,11817,7750,4067
2020,GBR,Kedah,4643,2556,2087
2020,GBR,Kelantan,136,101,35
2020,GBR,Melaka,8,8,0
2020,GBR,Negeri Sembilan,1,1,0
2020,GBR,Pahang,39,28,11
2020,GBR,Perak,202,127,75
2020,GBR,Perlis,808,507,301
2020,GBR,Pulau Pinang,3872,2297,1575
2020,GBR,Sabah,1518,818,700
2020,GBR,Sarawak,2879,1899,980
2020,GBR,Selangor,49010,31084,17926
2020,GBR,Terengganu,2,2,0
2020,GBR,W.P. Labuan,241,160,81
2020,GEO,Johor,20,16,4
2020,GEO,Kedah,18,12,6
2020,GEO,Melaka,1,1,0
2020,GEO,Perak,0,0,0
2020,GEO,Perlis,0,0,0
2020,GEO,Pulau Pinang,7,4,3
2020,GEO,Sabah,0,0,0
2020,GEO,Sarawak,0,0,0
2020,GEO,Selangor,149,113,36
2020,GHA,Johor,18,14,4
2020,GHA,Kedah,0,0,0
2020,GHA,Kelantan,1,1,0
2020,GHA,Pulau Pinang,1,1,0
2020,GHA,Sabah,0,0,0
2020,GHA,Sarawak,2,2,0
2020,GHA,Selangor,168,112,56
2020,GIB,Johor,0,0,0
2020,GIB,Sarawak,0,0,0
2020,GIN,Johor,22,22,0
2020,GIN,Kedah,0,0,0
2020,GIN,Kelantan,2,2,0
2020,GIN,Perlis,0,0,0
2020,GIN,Pulau Pinang,0,0,0
2020,GIN,Sabah,1,1,0
2020,GIN,Sarawak,2,1,1
2020,GIN,Selangor,164,134,30
2020,GLP,Selangor,1,1,0
2020,GMB,Johor,11,6,5
2020,GMB,Kedah,1,0,1
2020,GMB,Kelantan,2,2,0
2020,GMB,Pulau Pinang,3,2,1
2020,GMB,Sabah,0,0,0
2020,GMB,Sarawak,1,1,0
2020,GMB,Selangor,156,122,34
2020,GNB,Johor,5,5,0
2020,GNB,Selangor,3,3,0
2020,GNQ,Johor,0,0,0
2020,GNQ,Selangor,9,4,5
2020,GRC,Johor,128,104,24
2020,GRC,Kedah,70,41,29
2020,GRC,Kelantan,2,2,0
2020,GRC,Melaka,4,3,1
2020,GRC,Negeri Sembilan,0,0,0
2020,GRC,Pahang,3,3,0
2020,GRC,Perak,3,1,2
2020,GRC,Perlis,12,9,3
2020,GRC,Pulau Pinang,18,16,2
2020,GRC,Sabah,6,5,1
2020,GRC,Sarawak,23,15,8
2020,GRC,Selangor,707,515,192
2020,GRD,Johor,25,21,4
2020,GRD,Kedah,0,0,0
2020,GRD,Pulau Pinang,2,2,0
2020,GRD,Sabah,0,0,0
2020,GRD,Sarawak,0,0,0
2020,GRD,Selangor,33,20,13
2020,GRL,Johor,0,0,0
2020,GRL,Selangor,0,0,0
2020,GTM,Johor,2,1,1
2020,GTM,Kedah,1,1,0
2020,GTM,Pahang,1,0,1
2020,GTM,Perak,0,0,0
2020,GTM,Pulau Pinang,0,0,0
2020,GTM,Sabah,1,0,1
2020,GTM,Sarawak,0,0,0
2020,GTM,Selangor,41,26,15
2020,GTM,W.P. Labuan,0,0,0
2020,GUY,Johor,2,2,0
2020,GUY,Kedah,1,0,1
2020,GUY,Pulau Pinang,0,0,0
2020,GUY,Sarawak,0,0,0
2020,GUY,Selangor,15,9,6
2020,HKG,Johor,3,0,3
2020,HKG,Kedah,0,0,0
2020,HKG,Kelantan,0,0,0
2020,HKG,Pahang,0,0,0
2020,HKG,Perak,53,29,24
2020,HKG,Perlis,1,1,0
2020,HKG,Pulau Pinang,3,1,2
2020,HKG,Sabah,3,1,2
2020,HKG,Sarawak,23,16,7
2020,HKG,Selangor,13,10,3
2020,HKG,Terengganu,0,0,0
2020,HMD,Johor,0,0,0
2020,HND,Johor,20,9,11
2020,HND,Kedah,4,1,3
2020,HND,Perak,0,0,0
2020,HND,Pulau Pinang,1,1,0
2020,HND,Sabah,1,1,0
2020,HND,Sarawak,1,1,0
2020,HND,Selangor,50,37,13
2020,HRV,Johor,140,108,32
2020,HRV,Kedah,50,31,19
2020,HRV,Kelantan,0,0,0
2020,HRV,Melaka,0,0,0
2020,HRV,Pahang,11,10,1
2020,HRV,Perak,1,0,1
2020,HRV,Perlis,4,3,1
2020,HRV,Pulau Pinang,15,11,4
2020,HRV,Sabah,6,3,3
2020,HRV,Sarawak,14,13,1
2020,HRV,Selangor,760,527,233
2020,HTI,Johor,0,0,0
2020,HTI,Kedah,0,0,0
2020,HTI,Kelantan,0,0,0
2020,HTI,Perak,0,0,0
2020,HTI,Pulau Pinang,0,0,0
2020,HTI,Sabah,0,0,0
2020,HTI,Selangor,15,12,3
2020,HUN,Johor,183,116,67
2020,HUN,Kedah,739,375,364
2020,HUN,Kelantan,6,4,2
2020,HUN,Pahang,0,0,0
2020,HUN,Perak,2,1,1
2020,HUN,Perlis,12,6,6
2020,HUN,Pulau Pinang,140,78,62
2020,HUN,Sabah,36,21,15
2020,HUN,Sarawak,32,25,7
2020,HUN,Selangor,2612,1345,1267
2020,HUN,W.P. Labuan,2,1,1
2020,IDN,Johor,313241,171872,141369
2020,IDN,Kedah,8497,3431,5066
2020,IDN,Kelantan,536,332,204
2020,IDN,Melaka,10002,4609,5393
2020,IDN,Negeri Sembilan,8318,5449,2869
2020,IDN,Pahang,43,29,14
2020,IDN,Perak,455,170,285
2020,IDN,Perlis,1233,620,613
2020,IDN,Pulau Pinang,58594,22043,36551
2020,IDN,Sabah,12221,6367,5854
2020,IDN,Sarawak,90142,55589,34553
2020,IDN,Selangor,288643,140510,148133
2020,IDN,Terengganu,9,9,0
2020,IDN,W.P. Labuan,297,203,94
2020,IND,Johor,46150,34799,11351
2020,IND,Kedah,1593,955,638
2020,IND,Kelantan,41,34,7
2020,IND,Melaka,41,36,5
2020,IND,Negeri Sembilan,2,2,0
2020,IND,Pahang,41,31,10
2020,IND,Perak,737,496,241
2020,IND,Perlis,75,56,19
2020,IND,Pulau Pinang,1379,989,390
2020,IND,Sabah,239,174,65
2020,IND,Sarawak,4039,3491,548
2020,IND,Selangor,147097,108587,38510
2020,IND,Terengganu,3,3,0
2020,IND,W.P. Labuan,194,172,22
2020,IOT,Pulau Pinang,0,0,0
2020,IOT,Selangor,0,0,0
2020,IRL,Johor,687,457,230
2020,IRL,Kedah,281,149,132
2020,IRL,Kelantan,6,5,1
2020,IRL,Negeri Sembilan,0,0,0
2020,IRL,Pahang,3,2,1
2020,IRL,Perak,19,13,6
2020,IRL,Perlis,48,29,19
2020,IRL,Pulau Pinang,256,167,89
2020,IRL,Sabah,75,41,34
2020,IRL,Sarawak,75,47,28
2020,IRL,Selangor,3207,2015,1192
2020,IRL,Terengganu,0,0,0
2020,IRL,W.P. Labuan,6,5,1
2020,IRN,Johor,978,523,455
2020,IRN,Kedah,31,23,8
2020,IRN,Kelantan,1,1,0
2020,IRN,Perak,0,0,0
2020,IRN,Perlis,4,3,1
2020,IRN,Pulau Pinang,8,6,2
2020,IRN,Sabah,17,10,7
2020,IRN,Sarawak,14,10,4
2020,IRN,Selangor,8383,4614,3769
2020,IRN,W.P. Labuan,1,1,0
2020,IRQ,Johor,118,81,37
2020,IRQ,Kedah,10,7,3
2020,IRQ,Kelantan,0,0,0
2020,IRQ,Melaka,0,0,0
2020,IRQ,Pahang,0,0,0
2020,IRQ,Perak,0,0,0
2020,IRQ,Perlis,0,0,0
2020,IRQ,Pulau Pinang,23,15,8
2020,IRQ,Sabah,3,3,0
2020,IRQ,Sarawak,0,0,0
2020,IRQ,Selangor,3868,2694,1174
2020,ISL,Johor,13,10,3
2020,ISL,Kedah,12,8,4
2020,ISL,Kelantan,0,0,0
2020,ISL,Perak,0,0,0
2020,ISL,Perlis,5,2,3
2020,ISL,Pulau Pinang,2,1,1
2020,ISL,Sabah,11,6,5
2020,ISL,Sarawak,6,4,2
2020,ISL,Selangor,218,120,98
2020,ISL,W.P. Labuan,5,3,2
2020,ISR,Pulau Pinang,0,0,0
2020,ITA,Johor,1360,1005,355
2020,ITA,Kedah,1976,1066,910
2020,ITA,Kelantan,45,37,8
2020,ITA,Melaka,3,3,0
2020,ITA,Negeri Sembilan,2,2,0
2020,ITA,Pahang,1,0,1
2020,ITA,Perak,33,24,9
2020,ITA,Perlis,123,91,32
2020,ITA,Pulau Pinang,278,183,95
2020,ITA,Sabah,132,83,49
2020,ITA,Sarawak,133,85,48
2020,ITA,Selangor,7199,4902,2297
2020,ITA,W.P. Labuan,8,5,3
2020,JAM,Johor,9,2,7
2020,JAM,Kedah,1,0,1
2020,JAM,Perak,0,0,0
2020,JAM,Pulau Pinang,3,2,1
2020,JAM,Sabah,1,1,0
2020,JAM,Sarawak,1,1,0
2020,JAM,Selangor,67,22,45
2020,JAM,W.P. Labuan,0,0,0
2020,JOR,Johor,110,40,70
2020,JOR,Kedah,83,48,35
2020,JOR,Kelantan,1,1,0
2020,JOR,Melaka,0,0,0
2020,JOR,Perlis,3,3,0
2020,JOR,Pulau Pinang,59,31,28
2020,JOR,Sabah,11,9,2
2020,JOR,Sarawak,5,5,0
2020,JOR,Selangor,2349,1553,796
2020,JOR,W.P. Labuan,0,0,0
2020,JPN,Johor,18756,12401,6355
2020,JPN,Kedah,1300,682,618
2020,JPN,Kelantan,36,34,2
2020,JPN,Melaka,8,7,1
2020,JPN,Negeri Sembilan,0,0,0
2020,JPN,Pahang,23,17,6
2020,JPN,Perak,140,92,48
2020,JPN,Perlis,286,223,63
2020,JPN,Pulau Pinang,3617,2526,1091
2020,JPN,Sabah,2329,1129,1200
2020,JPN,Sarawak,661,480,181
2020,JPN,Selangor,71547,44107,27440
2020,JPN,W.P. Labuan,72,41,31
2020,KAZ,Johor,117,45,72
2020,KAZ,Kedah,580,261,319
2020,KAZ,Kelantan,10,3,7
2020,KAZ,Melaka,1,1,0
2020,KAZ,Perak,1,0,1
2020,KAZ,Perlis,16,9,7
2020,KAZ,Pulau Pinang,18,9,9
2020,KAZ,Sabah,14,8,6
2020,KAZ,Sarawak,17,6,11
2020,KAZ,Selangor,7163,2985,4178
2020,KAZ,W.P. Labuan,2,1,1
2020,KEN,Johor,175,79,96
2020,KEN,Kedah,5,3,2
2020,KEN,Kelantan,1,0,1
2020,KEN,Perak,0,0,0
2020,KEN,Perlis,3,1,2
2020,KEN,Pulau Pinang,8,5,3
2020,KEN,Sabah,1,1,0
2020,KEN,Sarawak,5,4,1
2020,KEN,Selangor,829,455,374
2020,KGZ,Johor,48,36,12
2020,KGZ,Kedah,55,31,24
2020,KGZ,Kelantan,0,0,0
2020,KGZ,Perak,0,0,0
2020,KGZ,Perlis,4,0,4
2020,KGZ,Pulau Pinang,9,3,6
2020,KGZ,Sabah,4,3,1
2020,KGZ,Sarawak,0,0,0
2020,KGZ,Selangor,1192,552,640
2020,KHM,Johor,4819,1972,2847
2020,KHM,Kedah,526,298,228
2020,KHM,Kelantan,3066,2379,687
2020,KHM,Melaka,0,0,0
2020,KHM,Negeri Sembilan,2,2,0
2020,KHM,Pahang,0,0,0
2020,KHM,Perak,71,58,13
2020,KHM,Perlis,1904,1455,449
2020,KHM,Pulau Pinang,19,4,15
2020,KHM,Sabah,8,6,2
2020,KHM,Sarawak,56,20,36
2020,KHM,Selangor,10239,4917,5322
2020,KHM,W.P. Labuan,0,0,0
2020,KIR,Johor,7,7,0
2020,KIR,Sabah,0,0,0
2020,KIR,Selangor,33,32,1
2020,KNA,Johor,19,15,4
2020,KNA,Kedah,0,0,0
2020,KNA,Perlis,0,0,0
2020,KNA,Pulau Pinang,10,4,6
2020,KNA,Sabah,1,1,0
2020,KNA,Selangor,106,81,25
2020,KNA,W.P. Labuan,0,0,0
2020,KOR,Johor,38646,18841,19805
2020,KOR,Kedah,873,434,439
2020,KOR,Kelantan,16,11,5
2020,KOR,Melaka,2,1,1
2020,KOR,Negeri Sembilan,7,4,3
2020,KOR,Pahang,28,14,14
2020,KOR,Perak,39,20,19
2020,KOR,Perlis,358,234,124
2020,KOR,Pulau Pinang,1125,578,547
2020,KOR,Sabah,47712,20076,27636
2020,KOR,Sarawak,821,491,330
2020,KOR,Selangor,50684,26210,24474
2020,KOR,Terengganu,1,1,0
2020,KOR,W.P. Labuan,50,36,14
2020,KWT,Johor,180,75,105
2020,KWT,Kedah,13,7,6
2020,KWT,Kelantan,1,0,1
2020,KWT,Perak,0,0,0
2020,KWT,Perlis,0,0,0
2020,KWT,Pulau Pinang,13,5,8
2020,KWT,Sabah,0,0,0
2020,KWT,Sarawak,0,0,0
2020,KWT,Selangor,1274,713,561
2020,KWT,W.P. Labuan,0,0,0
2020,LAO,Johor,386,115,271
2020,LAO,Kedah,2966,227,2739
2020,LAO,Kelantan,1070,752,318
2020,LAO,Melaka,0,0,0
2020,LAO,Perak,34,2,32
2020,LAO,Perlis,1179,336,843
2020,LAO,Pulau Pinang,24,6,18
2020,LAO,Sabah,2,0,2
2020,LAO,Sarawak,7,2,5
2020,LAO,Selangor,978,331,647
2020,LAO,W.P. Labuan,0,0,0
2020,LBN,Johor,36,24,12
2020,LBN,Kedah,5,4,1
2020,LBN,Kelantan,1,1,0
2020,LBN,Pahang,0,0,0
2020,LBN,Perak,0,0,0
2020,LBN,Perlis,0,0,0
2020,LBN,Pulau Pinang,10,4,6
2020,LBN,Sabah,2,2,0
2020,LBN,Sarawak,2,2,0
2020,LBN,Selangor,583,406,177
2020,LBN,W.P. Labuan,0,0,0
2020,LBR,Johor,5,5,0
2020,LBR,Kedah,0,0,0
2020,LBR,Sabah,0,0,0
2020,LBR,Sarawak,0,0,0
2020,LBR,Selangor,20,17,3
2020,LBY,Johor,30,20,10
2020,LBY,Kedah,6,5,1
2020,LBY,Perlis,0,0,0
2020,LBY,Pulau Pinang,11,7,4
2020,LBY,Sabah,4,4,0
2020,LBY,Sarawak,5,0,5
2020,LBY,Selangor,1807,1326,481
2020,LCA,Johor,8,6,2
2020,LCA,Kedah,0,0,0
2020,LCA,Pulau Pinang,0,0,0
2020,LCA,Sarawak,0,0,0
2020,LCA,Selangor,26,23,3
2020,LIE,Johor,6,5,1
2020,LIE,Kedah,2,2,0
2020,LIE,Perlis,0,0,0
2020,LIE,Pulau Pinang,1,1,0
2020,LIE,Sabah,0,0,0
2020,LIE,Sarawak,1,1,0
2020,LIE,Selangor,15,9,6
2020,LKA,Johor,2211,1604,607
2020,LKA,Kedah,30,19,11
2020,LKA,Kelantan,2,1,1
2020,LKA,Melaka,0,0,0
2020,LKA,Pahang,2,2,0
2020,LKA,Perak,7,5,2
2020,LKA,Perlis,0,0,0
2020,LKA,Pulau Pinang,81,58,23
2020,LKA,Sabah,5,4,1
2020,LKA,Sarawak,44,35,9
2020,LKA,Selangor,7985,5145,2840
2020,LKA,W.P. Labuan,1,0,1
2020,LSO,Johor,0,0,0
2020,LSO,Kedah,0,0,0
2020,LSO,Pulau Pinang,0,0,0
2020,LSO,Sarawak,0,0,0
2020,LSO,Selangor,14,9,5
2020,LTU,Johor,248,118,130
2020,LTU,Kedah,116,61,55
2020,LTU,Kelantan,3,2,1
2020,LTU,Pahang,0,0,0
2020,LTU,Perak,10,1,9
2020,LTU,Perlis,19,14,5
2020,LTU,Pulau Pinang,17,9,8
2020,LTU,Sabah,23,14,9
2020,LTU,Sarawak,20,9,11
2020,LTU,Selangor,903,482,421
2020,LTU,W.P. Labuan,5,4,1
2020,LUX,Johor,21,12,9
2020,LUX,Kedah,8,3,5
2020,LUX,Kelantan,2,0,2
2020,LUX,Perak,1,1,0
2020,LUX,Perlis,1,1,0
2020,LUX,Pulau Pinang,6,3,3
2020,LUX,Sabah,3,2,1
2020,LUX,Sarawak,0,0,0
2020,LUX,Selangor,105,65,40
2020,LVA,Johor,195,90,105
2020,LVA,Kedah,73,31,42
2020,LVA,Kelantan,0,0,0
2020,LVA,Pahang,0,0,0
2020,LVA,Perak,0,0,0
2020,LVA,Perlis,10,8,2
2020,LVA,Pulau Pinang,20,13,7
2020,LVA,Sabah,72,30,42
2020,LVA,Sarawak,4,2,2
2020,LVA,Selangor,568,276,292
2020,LVA,W.P. Labuan,0,0,0
2020,MAC,Johor,0,0,0
2020,MAC,Pahang,0,0,0
2020,MAC,Perak,0,0,0
2020,MAC,Selangor,0,0,0
2020,MAC,W.P. Labuan,0,0,0
2020,MAR,Johor,157,118,39
2020,MAR,Kedah,42,24,18
2020,MAR,Kelantan,6,5,1
2020,MAR,Melaka,0,0,0
2020,MAR,Pahang,0,0,0
2020,MAR,Perak,1,0,1
2020,MAR,Perlis,2,2,0
2020,MAR,Pulau Pinang,15,6,9
2020,MAR,Sabah,13,7,6
2020,MAR,Sarawak,12,8,4
2020,MAR,Selangor,2088,1103,985
2020,MAR,W.P. Labuan,1,1,0
2020,MCO,Johor,1,0,1
2020,MCO,Kedah,1,1,0
2020,MCO,Sabah,0,0,0
2020,MCO,Selangor,9,3,6
2020,MDA,Johor,13,6,7
2020,MDA,Kedah,21,11,10
2020,MDA,Kelantan,3,1,2
2020,MDA,Negeri Sembilan,0,0,0
2020,MDA,Perlis,0,0,0
2020,MDA,Pulau Pinang,5,1,4
2020,MDA,Sabah,9,5,4
2020,MDA,Sarawak,0,0,0
2020,MDA,Selangor,89,39,50
2020,MDG,Johor,25,12,13
2020,MDG,Kedah,4,1,3
2020,MDG,Perak,0,0,0
2020,MDG,Perlis,0,0,0
2020,MDG,Pulau Pinang,2,1,1
2020,MDG,Sabah,2,1,1
2020,MDG,Sarawak,0,0,0
2020,MDG,Selangor,112,61,51
2020,MDV,Johor,364,194,170
2020,MDV,Kedah,2,2,0
2020,MDV,Kelantan,0,0,0
2020,MDV,Perak,0,0,0
2020,MDV,Perlis,3,2,1
2020,MDV,Pulau Pinang,9,5,4
2020,MDV,Sabah,3,3,0
2020,MDV,Sarawak,0,0,0
2020,MDV,Selangor,4736,2583,2153
2020,MEX,Johor,288,160,128
2020,MEX,Kedah,24,10,14
2020,MEX,Kelantan,2,2,0
2020,MEX,Pahang,0,0,0
2020,MEX,Perak,2,1,1
2020,MEX,Perlis,7,6,1
2020,MEX,Pulau Pinang,43,26,17
2020,MEX,Sabah,10,5,5
2020,MEX,Sarawak,17,10,7
2020,MEX,Selangor,1257,650,607
2020,MEX,W.P. Labuan,1,1,0
2020,MHL,Johor,2,1,1
2020,MHL,Kedah,0,0,0
2020,MHL,Perak,0,0,0
2020,MHL,Pulau Pinang,0,0,0
2020,MHL,Sabah,0,0,0
2020,MHL,Selangor,8,5,3
2020,MKD,Johor,31,17,14
2020,MKD,Kedah,5,4,1
2020,MKD,Perak,0,0,0
2020,MKD,Pulau Pinang,0,0,0
2020,MKD,Sabah,2,1,1
2020,MKD,Sarawak,4,4,0
2020,MKD,Selangor,87,57,30
2020,MLI,Johor,4,4,0
2020,MLI,Sabah,0,0,0
2020,MLI,Selangor,27,22,5
2020,MLT,Johor,17,13,4
2020,MLT,Kedah,13,10,3
2020,MLT,Kelantan,0,0,0
2020,MLT,Perak,2,0,2
2020,MLT,Perlis,0,0,0
2020,MLT,Pulau Pinang,3,3,0
2020,MLT,Sabah,3,2,1
2020,MLT,Sarawak,0,0,0
2020,MLT,Selangor,96,68,28
2020,MLT,W.P. Labuan,2,1,1
2020,MMR,Johor,8946,3167,5779
2020,MMR,Kedah,58,40,18
2020,MMR,Kelantan,9,2,7
2020,MMR,Negeri Sembilan,0,0,0
2020,MMR,Pahang,13,11,2
2020,MMR,Perak,27,5,22
2020,MMR,Perlis,10,1,9
2020,MMR,Pulau Pinang,825,555,270
2020,MMR,Sabah,20,6,14
2020,MMR,Sarawak,179,105,74
2020,MMR,Selangor,26717,20391,6326
2020,MMR,Terengganu,0,0,0
2020,MMR,W.P. Labuan,5,3,2
2020,MNE,Johor,10,10,0
2020,MNE,Kedah,0,0,0
2020,MNE,Pulau Pinang,1,1,0
2020,MNE,Sabah,3,2,1
2020,MNE,Sarawak,0,0,0
2020,MNE,Selangor,64,45,19
2020,MNG,Johor,363,154,209
2020,MNG,Kedah,52,7,45
2020,MNG,Kelantan,0,0,0
2020,MNG,Perak,0,0,0
2020,MNG,Perlis,5,1,4
2020,MNG,Pulau Pinang,16,9,7
2020,MNG,Sabah,12,5,7
2020,MNG,Sarawak,7,6,1
2020,MNG,Selangor,924,381,543
2020,MNP,Selangor,2,2,0
2020,MOZ,Johor,0,0,0
2020,MOZ,Kedah,0,0,0
2020,MOZ,Perak,1,1,0
2020,MOZ,Pulau Pinang,0,0,0
2020,MOZ,Sabah,1,1,0
2020,MOZ,Sarawak,0,0,0
2020,MOZ,Selangor,116,71,45
2020,MRT,Johor,1,1,0
2020,MRT,Kedah,1,1,0
2020,MRT,Pulau Pinang,0,0,0
2020,MRT,Sabah,0,0,0
2020,MRT,Sarawak,0,0,0
2020,MRT,Selangor,70,56,14
2020,MUS,Johor,398,219,179
2020,MUS,Kedah,4,2,2
2020,MUS,Kelantan,0,0,0
2020,MUS,Pahang,1,1,0
2020,MUS,Perak,0,0,0
2020,MUS,Perlis,1,0,1
2020,MUS,Pulau Pinang,9,4,5
2020,MUS,Sabah,7,5,2
2020,MUS,Sarawak,1,1,0
2020,MUS,Selangor,2019,1033,986
2020,MWI,Johor,3,3,0
2020,MWI,Pulau Pinang,1,1,0
2020,MWI,Sabah,0,0,0
2020,MWI,Sarawak,0,0,0
2020,MWI,Selangor,63,34,29
2020,MYT,Selangor,1,0,1
2020,NAM,Johor,4,2,2
2020,NAM,Kedah,1,0,1
2020,NAM,Perak,0,0,0
2020,NAM,Perlis,1,0,1
2020,NAM,Pulau Pinang,2,0,2
2020,NAM,Sabah,0,0,0
2020,NAM,Sarawak,0,0,0
2020,NAM,Selangor,54,23,31
2020,NCL,Selangor,0,0,0
2020,NER,Johor,0,0,0
2020,NER,Sabah,0,0,0
2020,NER,Selangor,12,9,3
2020,NGA,Johor,56,48,8
2020,NGA,Kedah,2,2,0
2020,NGA,Perlis,1,1,0
2020,NGA,Pulau Pinang,25,19,6
2020,NGA,Sabah,0,0,0
2020,NGA,Sarawak,16,13,3
2020,NGA,Selangor,2032,1681,351
2020,NIC,Johor,5,3,2
2020,NIC,Kedah,1,1,0
2020,NIC,Pulau Pinang,1,1,0
2020,NIC,Sabah,1,0,1
2020,NIC,Selangor,19,10,9
2020,NLD,Johor,2403,1571,832
2020,NLD,Kedah,1181,602,579
2020,NLD,Kelantan,28,19,9
2020,NLD,Melaka,12,6,6
2020,NLD,Negeri Sembilan,0,0,0
2020,NLD,Pahang,4,3,1
2020,NLD,Perak,41,26,15
2020,NLD,Perlis,158,97,61
2020,NLD,Pulau Pinang,612,395,217
2020,NLD,Sabah,209,117,92
2020,NLD,Sarawak,559,360,199
2020,NLD,Selangor,11812,7266,4546
2020,NLD,Terengganu,0,0,0
2020,NLD,W.P. Labuan,26,16,10
2020,NOR,Johor,543,322,221
2020,NOR,Kedah,503,252,251
2020,NOR,Kelantan,2,1,1
2020,NOR,Melaka,0,0,0
2020,NOR,Pahang,5,3,2
2020,NOR,Perak,8,6,2
2020,NOR,Perlis,41,24,17
2020,NOR,Pulau Pinang,162,99,63
2020,NOR,Sabah,36,27,9
2020,NOR,Sarawak,90,63,27
2020,NOR,Selangor,2779,1633,1146
2020,NOR,W.P. Labuan,3,3,0
2020,NPL,Johor,2470,2103,367
2020,NPL,Kedah,23,18,5
2020,NPL,Pahang,0,0,0
2020,NPL,Perak,0,0,0
2020,NPL,Perlis,2,2,0
2020,NPL,Pulau Pinang,225,210,15
2020,NPL,Sabah,62,62,0
2020,NPL,Sarawak,397,288,109
2020,NPL,Selangor,30139,28610,1529
2020,NPL,W.P. Labuan,240,202,38
2020,NRU,Johor,0,0,0
2020,NRU,Pulau Pinang,1,1,0
2020,NRU,Selangor,2,2,0
2020,NZL,Johor,2083,1270,813
2020,NZL,Kedah,309,189,120
2020,NZL,Kelantan,11,7,4
2020,NZL,Melaka,5,2,3
2020,NZL,Negeri Sembilan,0,0,0
2020,NZL,Pahang,5,5,0
2020,NZL,Perak,53,33,20
2020,NZL,Perlis,61,43,18
2020,NZL,Pulau Pinang,513,292,221
2020,NZL,Sabah,171,92,79
2020,NZL,Sarawak,392,234,158
2020,NZL,Selangor,7201,4306,2895
2020,NZL,Terengganu,0,0,0
2020,NZL,W.P. Labuan,12,10,2
2020,OMN,Johor,75,49,26
2020,OMN,Kedah,22,14,8
2020,OMN,Kelantan,0,0,0
2020,OMN,Melaka,0,0,0
2020,OMN,Perak,0,0,0
2020,OMN,Perlis,4,4,0
2020,OMN,Pulau Pinang,29,15,14
2020,OMN,Sabah,1,1,0
2020,OMN,Sarawak,60,33,27
2020,OMN,Selangor,3186,1890,1296
2020,PAK,Johor,2136,1640,496
2020,PAK,Kedah,246,165,81
2020,PAK,Kelantan,25,25,0
2020,PAK,Melaka,0,0,0
2020,PAK,Negeri Sembilan,0,0,0
2020,PAK,Pahang,1,1,0
2020,PAK,Perak,12,11,1
2020,PAK,Perlis,45,38,7
2020,PAK,Pulau Pinang,122,104,18
2020,PAK,Sabah,45,38,7
2020,PAK,Sarawak,895,837,58
2020,PAK,Selangor,33043,28154,4889
2020,PAK,W.P. Labuan,39,39,0
2020,PAN,Johor,18,13,5
2020,PAN,Kedah,2,1,1
2020,PAN,Perak,0,0,0
2020,PAN,Perlis,0,0,0
2020,PAN,Pulau Pinang,2,2,0
2020,PAN,Sabah,4,2,2
2020,PAN,Sarawak,0,0,0
2020,PAN,Selangor,95,42,53
2020,PER,Johor,82,42,40
2020,PER,Kedah,23,8,15
2020,PER,Kelantan,2,1,1
2020,PER,Pahang,0,0,0
2020,PER,Perak,0,0,0
2020,PER,Perlis,3,2,1
2020,PER,Pulau Pinang,9,4,5
2020,PER,Sabah,7,3,4
2020,PER,Sarawak,3,2,1
2020,PER,Selangor,378,202,176
2020,PER,W.P. Labuan,1,0,1
2020,PHL,Johor,40530,13114,27416
2020,PHL,Kedah,3061,1046,2015
2020,PHL,Kelantan,145,67,78
2020,PHL,Melaka,0,0,0
2020,PHL,Negeri Sembilan,1,0,1
2020,PHL,Pahang,42,33,9
2020,PHL,Perak,141,43,98
2020,PHL,Perlis,506,170,336
2020,PHL,Pulau Pinang,986,370,616
2020,PHL,Sabah,5735,2894,2841
2020,PHL,Sarawak,8293,3722,4571
2020,PHL,Selangor,37013,16429,20584
2020,PHL,Terengganu,0,0,0
2020,PHL,W.P. Labuan,558,265,293
2020,PLW,Johor,0,0,0
2020,PLW,Pulau Pinang,0,0,0
2020,PLW,Selangor,0,0,0
2020,PNG,Johor,34,25,9
2020,PNG,Kedah,0,0,0
2020,PNG,Kelantan,1,0,1
2020,PNG,Perak,0,0,0
2020,PNG,Pulau Pinang,2,0,2
2020,PNG,Sabah,8,5,3
2020,PNG,Sarawak,9,4,5
2020,PNG,Selangor,146,82,64
2020,POL,Johor,1660,868,792
2020,POL,Kedah,1089,544,545
2020,POL,Kelantan,16,4,12
2020,POL,Melaka,1,1,0
2020,POL,Negeri Sembilan,1,1,0
2020,POL,Pahang,0,0,0
2020,POL,Perak,8,3,5
2020,POL,Perlis,146,78,68
2020,POL,Pulau Pinang,274,135,139
2020,POL,Sabah,201,97,104
2020,POL,Sarawak,180,98,82
2020,POL,Selangor,4788,2563,2225
2020,POL,Terengganu,0,0,0
2020,POL,W.P. Labuan,22,15,7
2020,PRK,Selangor,8,7,1
2020,PRT,Johor,421,220,201
2020,PRT,Kedah,252,129,123
2020,PRT,Kelantan,5,3,2
2020,PRT,Melaka,0,0,0
2020,PRT,Pahang,0,0,0
2020,PRT,Perak,4,2,2
2020,PRT,Perlis,22,14,8
2020,PRT,Pulau Pinang,42,21,21
2020,PRT,Sabah,53,27,26
2020,PRT,Sarawak,25,15,10
2020,PRT,Selangor,1402,805,597
2020,PRT,W.P. Labuan,2,1,1
2020,PRY,Johor,6,3,3
2020,PRY,Kedah,2,2,0
2020,PRY,Perak,0,0,0
2020,PRY,Perlis,1,1,0
2020,PRY,Pulau Pinang,0,0,0
2020,PRY,Sabah,0,0,0
2020,PRY,Sarawak,0,0,0
2020,PRY,Selangor,26,7,19
2020,PSE,Johor,21,12,9
2020,PSE,Kedah,18,10,8
2020,PSE,Kelantan,0,0,0
2020,PSE,Melaka,0,0,0
2020,PSE,Perak,0,0,0
2020,PSE,Perlis,0,0,0
2020,PSE,Pulau Pinang,11,7,4
2020,PSE,Sabah,3,3,0
2020,PSE,Sarawak,5,5,0
2020,PSE,Selangor,1157,900,257
2020,QAT,Johor,8,4,4
2020,QAT,Kedah,15,9,6
2020,QAT,Perlis,0,0,0
2020,QAT,Pulau Pinang,3,2,1
2020,QAT,Sabah,0,0,0
2020,QAT,Sarawak,1,1,0
2020,QAT,Selangor,203,150,53
2020,REU,Johor,0,0,0
2020,REU,Sarawak,0,0,0
2020,ROU,Johor,365,216,149
2020,ROU,Kedah,442,214,228
2020,ROU,Kelantan,6,4,2
2020,ROU,Negeri Sembilan,2,2,0
2020,ROU,Pahang,0,0,0
2020,ROU,Perak,4,2,2
2020,ROU,Perlis,7,3,4
2020,ROU,Pulau Pinang,58,34,24
2020,ROU,Sabah,21,11,10
2020,ROU,Sarawak,24,14,10
2020,ROU,Selangor,2186,1170,1016
2020,ROU,W.P. Labuan,5,3,2
2020,RUS,Johor,1269,791,478
2020,RUS,Kedah,3564,1636,1928
2020,RUS,Kelantan,305,140,165
2020,RUS,Melaka,6,6,0
2020,RUS,Negeri Sembilan,0,0,0
2020,RUS,Pahang,13,11,2
2020,RUS,Perak,16,8,8
2020,RUS,Perlis,805,400,405
2020,RUS,Pulau Pinang,371,186,185
2020,RUS,Sabah,364,155,209
2020,RUS,Sarawak,182,96,86
2020,RUS,Selangor,26739,12463,14276
2020,RUS,W.P. Labuan,40,17,23
2020,RWA,Johor,1,1,0
2020,RWA,Kedah,0,0,0
2020,RWA,Pulau Pinang,0,0,0
2020,RWA,Selangor,18,8,10
2020,SAU,Johor,382,202,180
2020,SAU,Kedah,81,40,41
2020,SAU,Kelantan,9,4,5
2020,SAU,Melaka,0,0,0
2020,SAU,Perak,2,1,1
2020,SAU,Perlis,1,1,0
2020,SAU,Pulau Pinang,78,42,36
2020,SAU,Sabah,4,3,1
2020,SAU,Sarawak,12,11,1
2020,SAU,Selangor,24024,12687,11337
2020,SAU,W.P. Labuan,1,1,0
2020,SDN,Johor,20,19,1
2020,SDN,Kedah,2,2,0
2020,SDN,Kelantan,0,0,0
2020,SDN,Perlis,2,1,1
2020,SDN,Pulau Pinang,2,1,1
2020,SDN,Sabah,3,3,0
2020,SDN,Sarawak,5,5,0
2020,SDN,Selangor,3040,1888,1152
2020,SDN,W.P. Labuan,0,0,0
2020,SEN,Johor,18,14,4
2020,SEN,Kedah,1,1,0
2020,SEN,Kelantan,0,0,0
2020,SEN,Perak,0,0,0
2020,SEN,Perlis,0,0,0
2020,SEN,Pulau Pinang,1,1,0
2020,SEN,Sabah,0,0,0
2020,SEN,Sarawak,1,0,1
2020,SEN,Selangor,155,117,38
2020,SGP,Johor,2666810,1613319,1053491
2020,SGP,Kedah,4830,2840,1990
2020,SGP,Kelantan,724,378,346
2020,SGP,Melaka,57,45,12
2020,SGP,Negeri Sembilan,3,2,1
2020,SGP,Pahang,904,467,437
2020,SGP,Perak,8427,4233,4194
2020,SGP,Perlis,375,233,142
2020,SGP,Pulau Pinang,19702,10521,9181
2020,SGP,Sabah,3559,1952,1607
2020,SGP,Sarawak,6246,3636,2610
2020,SGP,Selangor,66106,39115,26991
2020,SGP,Terengganu,9,8,1
2020,SGP,W.P. Labuan,69,57,12
2020,SGS,Johor,0,0,0
2020,SGS,Sabah,0,0,0
2020,SGS,Selangor,0,0,0
2020,SHN,Sarawak,0,0,0
2020,SLB,Johor,7,7,0
2020,SLB,Perlis,0,0,0
2020,SLB,Pulau Pinang,0,0,0
2020,SLB,Sabah,2,0,2
2020,SLB,Sarawak,22,8,14
2020,SLB,Selangor,14,6,8
2020,SLB,W.P. Labuan,0,0,0
2020,SLE,Johor,3,2,1
2020,SLE,Kedah,0,0,0
2020,SLE,Perak,0,0,0
2020,SLE,Pulau Pinang,3,2,1
2020,SLE,Sabah,0,0,0
2020,SLE,Selangor,116,75,41
2020,SLV,Johor,2,1,1
2020,SLV,Kedah,1,0,1
2020,SLV,Perak,0,0,0
2020,SLV,Perlis,0,0,0
2020,SLV,Pulau Pinang,3,0,3
2020,SLV,Sabah,3,1,2
2020,SLV,Selangor,44,21,23
2020,SLV,W.P. Labuan,1,0,1
2020,SMR,Johor,0,0,0
2020,SMR,Selangor,8,6,2
2020,SOM,Johor,8,6,2
2020,SOM,Kedah,2,2,0
2020,SOM,Kelantan,0,0,0
2020,SOM,Perlis,1,0,1
2020,SOM,Sabah,1,0,1
2020,SOM,Sarawak,0,0,0
2020,SOM,Selangor,864,547,317
2020,SRB,Johor,32,22,10
2020,SRB,Kedah,22,14,8
2020,SRB,Kelantan,0,0,0
2020,SRB,Pahang,0,0,0
2020,SRB,Perak,0,0,0
2020,SRB,Perlis,0,0,0
2020,SRB,Pulau Pinang,6,5,1
2020,SRB,Sabah,8,5,3
2020,SRB,Sarawak,0,0,0
2020,SRB,Selangor,286,157,129
2020,SSD,Johor,2,2,0
2020,SSD,Kedah,1,1,0
2020,SSD,Sarawak,1,1,0
2020,SSD,Selangor,55,39,16
2020,SSD,W.P. Labuan,1,1,0
2020,STP,Selangor,10,5,5
2020,SUR,Johor,10,5,5
2020,SUR,Kedah,0,0,0
2020,SUR,Kelantan,0,0,0
2020,SUR,Perak,1,0,1
2020,SUR,Perlis,0,0,0
2020,SUR,Pulau Pinang,0,0,0
2020,SUR,Sabah,0,0,0
2020,SUR,Sarawak,1,1,0
2020,SUR,Selangor,20,13,7
2020,SVK,Johor,90,58,32
2020,SVK,Kedah,656,325,331
2020,SVK,Kelantan,6,6,0
2020,SVK,Negeri Sembilan,0,0,0
2020,SVK,Pahang,1,0,1
2020,SVK,Perak,2,1,1
2020,SVK,Perlis,7,4,3
2020,SVK,Pulau Pinang,84,36,48
2020,SVK,Sabah,40,21,19
2020,SVK,Sarawak,14,9,5
2020,SVK,Selangor,1400,754,646
2020,SVK,W.P. Labuan,6,5,1
2020,SVN,Johor,49,30,19
2020,SVN,Kedah,110,58,52
2020,SVN,Kelantan,0,0,0
2020,SVN,Perak,0,0,0
2020,SVN,Perlis,5,4,1
2020,SVN,Pulau Pinang,9,6,3
2020,SVN,Sabah,14,6,8
2020,SVN,Sarawak,5,3,2
2020,SVN,Selangor,470,268,202
2020,SVN,W.P. Labuan,0,0,0
2020,SWE,Johor,966,560,406
2020,SWE,Kedah,2403,1132,1271
2020,SWE,Kelantan,34,28,6
2020,SWE,Melaka,1,0,1
2020,SWE,Negeri Sembilan,0,0,0
2020,SWE,Pahang,7,3,4
2020,SWE,Perak,18,13,5
2020,SWE,Perlis,85,65,20
2020,SWE,Pulau Pinang,335,211,124
2020,SWE,Sabah,110,58,52
2020,SWE,Sarawak,77,47,30
2020,SWE,Selangor,6226,3570,2656
2020,SWE,W.P. Labuan,9,4,5
2020,SWZ,Johor,1,0,1
2020,SWZ,Kedah,0,0,0
2020,SWZ,Pulau Pinang,0,0,0
2020,SWZ,Sabah,0,0,0
2020,SWZ,Selangor,23,13,10
2020,SYC,Johor,22,12,10
2020,SYC,Kedah,1,1,0
2020,SYC,Pulau Pinang,0,0,0
2020,SYC,Sabah,0,0,0
2020,SYC,Sarawak,4,3,1
2020,SYC,Selangor,253,119,134
2020,SYR,Johor,39,29,10
2020,SYR,Kedah,15,10,5
2020,SYR,Kelantan,0,0,0
2020,SYR,Pahang,8,8,0
2020,SYR,Perlis,1,1,0
2020,SYR,Pulau Pinang,9,6,3
2020,SYR,Sabah,3,3,0
2020,SYR,Sarawak,5,2,3
2020,SYR,Selangor,2227,1554,673
2020,SYR,W.P. Labuan,0,0,0
2020,TCA,Perlis,0,0,0
2020,TCD,Johor,2,1,1
2020,TCD,Kedah,0,0,0
2020,TCD,Perlis,0,0,0
2020,TCD,Selangor,57,48,9
2020,TGO,Johor,3,3,0
2020,TGO,Perak,0,0,0
2020,TGO,Pulau Pinang,0,0,0
2020,TGO,Selangor,27,24,3
2020,THA,Johor,13175,4191,8984
2020,THA,Kedah,217617,139975,77642
2020,THA,Kelantan,93115,48842,44273
2020,THA,Melaka,7,6,1
2020,THA,Negeri Sembilan,4,3,1
2020,THA,Pahang,0,0,0
2020,THA,Perak,33981,15685,18296
2020,THA,Perlis,149768,99793,49975
2020,THA,Pulau Pinang,2649,1021,1628
2020,THA,Sabah,271,81,190
2020,THA,Sarawak,1553,675,878
2020,THA,Selangor,25155,10590,14565
2020,THA,Terengganu,3,3,0
2020,THA,W.P. Labuan,38,9,29
2020,TJK,Johor,5,4,1
2020,TJK,Kedah,8,7,1
2020,TJK,Perlis,0,0,0
2020,TJK,Pulau Pinang,2,0,2
2020,TJK,Sabah,2,2,0
2020,TJK,Selangor,309,226,83
2020,TKL,Selangor,2,2,0
2020,TKM,Johor,5,2,3
2020,TKM,Kedah,3,2,1
2020,TKM,Kelantan,0,0,0
2020,TKM,Perlis,1,1,0
2020,TKM,Pulau Pinang,0,0,0
2020,TKM,Sabah,5,2,3
2020,TKM,Sarawak,0,0,0
2020,TKM,Selangor,347,208,139
2020,TLS,Johor,7,3,4
2020,TLS,Kedah,0,0,0
2020,TLS,Perlis,0,0,0
2020,TLS,Pulau Pinang,12,6,6
2020,TLS,Sabah,0,0,0
2020,TLS,Sarawak,4,3,1
2020,TLS,Selangor,235,132,103
2020,TON,Johor,1,1,0
2020,TON,Pulau Pinang,2,1,1
2020,TON,Sarawak,1,0,1
2020,TON,Selangor,19,13,6
2020,TTO,Johor,39,34,5
2020,TTO,Kedah,0,0,0
2020,TTO,Pahang,0,0,0
2020,TTO,Pulau Pinang,4,2,2
2020,TTO,Sabah,0,0,0
2020,TTO,Sarawak,1,1,0
2020,TTO,Selangor,71,43,28
2020,TUN,Johor,28,19,9
2020,TUN,Kedah,36,25,11
2020,TUN,Kelantan,0,0,0
2020,TUN,Melaka,0,0,0
2020,TUN,Perak,0,0,0
2020,TUN,Perlis,0,0,0
2020,TUN,Pulau Pinang,12,7,5
2020,TUN,Sabah,3,0,3
2020,TUN,Sarawak,2,1,1
2020,TUN,Selangor,803,440,363
2020,TUN,W.P. Labuan,0,0,0
2020,TUR,Johor,632,450,182
2020,TUR,Kedah,164,121,43
2020,TUR,Kelantan,11,11,0
2020,TUR,Melaka,1,1,0
2020,TUR,Negeri Sembilan,0,0,0
2020,TUR,Pahang,2,0,2
2020,TUR,Perak,1,1,0
2020,TUR,Perlis,31,27,4
2020,TUR,Pulau Pinang,39,25,14
2020,TUR,Sabah,30,24,6
2020,TUR,Sarawak,61,50,11
2020,TUR,Selangor,2803,1929,874
2020,TUR,W.P. Labuan,3,3,0
2020,TUV,Selangor,0,0,0
2020,TWN,Johor,16099,6913,9186
2020,TWN,Kedah,386,196,190
2020,TWN,Kelantan,13,8,5
2020,TWN,Melaka,25,8,17
2020,TWN,Negeri Sembilan,0,0,0
2020,TWN,Pahang,319,154,165
2020,TWN,Perak,68,23,45
2020,TWN,Perlis,42,23,19
2020,TWN,Pulau Pinang,7118,3651,3467
2020,TWN,Sabah,6660,3172,3488
2020,TWN,Sarawak,738,287,451
2020,TWN,Selangor,35361,17751,17610
2020,TWN,W.P. Labuan,31,17,14
2020,TZA,Johor,64,38,26
2020,TZA,Kedah,1,1,0
2020,TZA,Perak,0,0,0
2020,TZA,Perlis,0,0,0
2020,TZA,Pulau Pinang,0,0,0
2020,TZA,Sabah,4,1,3
2020,TZA,Sarawak,2,1,1
2020,TZA,Selangor,544,286,258
2020,UGA,Johor,86,32,54
2020,UGA,Kedah,1,0,1
2020,UGA,Perak,0,0,0
2020,UGA,Perlis,0,0,0
2020,UGA,Pulau Pinang,3,0,3
2020,UGA,Sabah,1,0,1
2020,UGA,Sarawak,1,1,0
2020,UGA,Selangor,247,127,120
2020,UKR,Johor,417,295,122
2020,UKR,Kedah,997,474,523
2020,UKR,Kelantan,48,26,22
2020,UKR,Melaka,10,10,0
2020,UKR,Negeri Sembilan,1,1,0
2020,UKR,Pahang,12,12,0
2020,UKR,Perak,4,3,1
2020,UKR,Perlis,80,42,38
2020,UKR,Pulau Pinang,132,60,72
2020,UKR,Sabah,67,31,36
2020,UKR,Sarawak,65,41,24
2020,UKR,Selangor,5802,3130,2672
2020,UKR,W.P. Labuan,18,11,7
2020,URY,Johor,202,93,109
2020,URY,Kedah,5,2,3
2020,URY,Kelantan,28,10,18
2020,URY,Perak,0,0,0
2020,URY,Perlis,4,1,3
2020,URY,Pulau Pinang,8,3,5
2020,URY,Sabah,1,1,0
2020,URY,Sarawak,0,0,0
2020,URY,Selangor,232,104,128
2020,URY,W.P. Labuan,0,0,0
2020,USA,Johor,9988,5877,4111
2020,USA,Kedah,1598,902,696
2020,USA,Kelantan,89,60,29
2020,USA,Melaka,8,5,3
2020,USA,Negeri Sembilan,0,0,0
2020,USA,Pahang,22,9,13
2020,USA,Perak,193,107,86
2020,USA,Perlis,295,188,107
2020,USA,Pulau Pinang,3942,2332,1610
2020,USA,Sabah,1086,598,488
2020,USA,Sarawak,815,471,344
2020,USA,Selangor,36384,21661,14723
2020,USA,Terengganu,0,0,0
2020,USA,W.P. Labuan,36,25,11
2020,UZB,Johor,185,117,68
2020,UZB,Kedah,242,67,175
2020,UZB,Kelantan,6,4,2
2020,UZB,Perak,1,1,0
2020,UZB,Perlis,2,0,2
2020,UZB,Pulau Pinang,31,13,18
2020,UZB,Sabah,10,10,0
2020,UZB,Sarawak,7,6,1
2020,UZB,Selangor,3638,2240,1398
2020,VAT,Johor,1,1,0
2020,VAT,Sarawak,0,0,0
2020,VAT,Selangor,5,5,0
2020,VCT,Johor,1,0,1
2020,VCT,Kedah,1,0,1
2020,VCT,Pulau Pinang,0,0,0
2020,VCT,Sarawak,0,0,0
2020,VCT,Selangor,3,3,0
2020,VEN,Johor,55,32,23
2020,VEN,Kedah,6,4,2
2020,VEN,Kelantan,2,2,0
2020,VEN,Melaka,1,0,1
2020,VEN,Perak,1,0,1
2020,VEN,Perlis,0,0,0
2020,VEN,Pulau Pinang,4,3,1
2020,VEN,Sabah,6,5,1
2020,VEN,Sarawak,16,9,7
2020,VEN,Selangor,232,132,100
2020,VEN,W.P. Labuan,0,0,0
2020,VNM,Johor,25019,7376,17643
2020,VNM,Kedah,1480,123,1357
2020,VNM,Kelantan,76,35,41
2020,VNM,Melaka,4,0,4
2020,VNM,Negeri Sembilan,2,2,0
2020,VNM,Pahang,5,3,2
2020,VNM,Perak,164,23,141
2020,VNM,Perlis,340,66,274
2020,VNM,Pulau Pinang,2233,520,1713
2020,VNM,Sabah,92,30,62
2020,VNM,Sarawak,1349,351,998
2020,VNM,Selangor,41277,14363,26914
2020,VNM,Terengganu,20,20,0
2020,VNM,W.P. Labuan,18,14,4
2020,VUT,Johor,59,45,14
2020,VUT,Kedah,2,2,0
2020,VUT,Pulau Pinang,9,7,2
2020,VUT,Sabah,5,5,0
2020,VUT,Sarawak,0,0,0
2020,VUT,Selangor,151,131,20
2020,WSM,Johor,0,0,0
2020,WSM,Sarawak,0,0,0
2020,WSM,Selangor,9,5,4
2020,XXX,Johor,502,268,234
2020,XXX,Kedah,56,26,30
2020,XXX,Kelantan,0,0,0
2020,XXX,Melaka,1,0,1
2020,XXX,Pahang,0,0,0
2020,XXX,Perak,19,14,5
2020,XXX,Perlis,8,7,1
2020,XXX,Pulau Pinang,240,128,112
2020,XXX,Sabah,71,38,33
2020,XXX,Sarawak,165,122,43
2020,XXX,Selangor,1969,1195,774
2020,XXX,W.P. Labuan,3,3,0
2020,YEM,Johor,111,72,39
2020,YEM,Kedah,13,10,3
2020,YEM,Kelantan,1,1,0
2020,YEM,Melaka,18,12,6
2020,YEM,Pahang,0,0,0
2020,YEM,Perak,0,0,0
2020,YEM,Perlis,2,2,0
2020,YEM,Pulau Pinang,20,18,2
2020,YEM,Sabah,2,2,0
2020,YEM,Sarawak,5,3,2
2020,YEM,Selangor,6257,4612,1645
2020,YEM,W.P. Labuan,0,0,0
2020,ZAF,Johor,777,472,305
2020,ZAF,Kedah,221,127,94
2020,ZAF,Kelantan,42,20,22
2020,ZAF,Melaka,2,0,2
2020,ZAF,Pahang,2,1,1
2020,ZAF,Perak,2,2,0
2020,ZAF,Perlis,33,17,16
2020,ZAF,Pulau Pinang,131,72,59
2020,ZAF,Sabah,37,20,17
2020,ZAF,Sarawak,164,105,59
2020,ZAF,Selangor,3449,1931,1518
2020,ZAF,Terengganu,0,0,0
2020,ZAF,W.P. Labuan,16,7,9
2020,ZAR,Selangor,1,0,1
2020,ZMB,Johor,10,6,4
2020,ZMB,Kedah,1,1,0
2020,ZMB,Perak,0,0,0
2020,ZMB,Perlis,0,0,0
2020,ZMB,Pulau Pinang,5,2,3
2020,ZMB,Sabah,0,0,0
2020,ZMB,Sarawak,2,2,0
2020,ZMB,Selangor,221,121,100
2020,ZWE,Johor,64,40,24
2020,ZWE,Kedah,0,0,0
2020,ZWE,Kelantan,3,3,0
2020,ZWE,Perak,0,0,0
2020,ZWE,Perlis,1,1,0
2020,ZWE,Pulau Pinang,2,2,0
2020,ZWE,Sabah,4,2,2
2020,ZWE,Sarawak,1,0,1
2020,ZWE,Selangor,399,217,182
2021,ABW,Kedah,0,0,0
2021,ABW,Pulau Pinang,0,0,0
2021,AFG,Johor,0,0,0
2021,AFG,Kedah,0,0,0
2021,AFG,Perlis,0,0,0
2021,AFG,Pulau Pinang,0,0,0
2021,AFG,Sarawak,0,0,0
2021,AFG,Selangor,304,215,89
2021,AGO,Johor,0,0,0
2021,AGO,Kedah,0,0,0
2021,AGO,Sabah,0,0,0
2021,AGO,Selangor,4,3,1
2021,AIA,Selangor,0,0,0
2021,ALB,Johor,0,0,0
2021,ALB,Kedah,0,0,0
2021,ALB,Perak,0,0,0
2021,ALB,Perlis,0,0,0
2021,ALB,Pulau Pinang,0,0,0
2021,ALB,Sabah,0,0,0
2021,ALB,Sarawak,0,0,0
2021,ALB,Selangor,15,10,5
2021,AND,Johor,0,0,0
2021,AND,Kedah,0,0,0
2021,AND,Perlis,0,0,0
2021,AND,Pulau Pinang,0,0,0
2021,AND,Selangor,0,0,0
2021,ANT,Selangor,1,0,1
2021,ARE,Johor,0,0,0
2021,ARE,Kedah,0,0,0
2021,ARE,Kelantan,0,0,0
2021,ARE,Perak,0,0,0
2021,ARE,Perlis,0,0,0
2021,ARE,Pulau Pinang,0,0,0
2021,ARE,Sabah,0,0,0
2021,ARE,Sarawak,43,43,0
2021,ARE,Selangor,60,43,17
2021,ARG,Johor,2,2,0
2021,ARG,Kedah,0,0,0
2021,ARG,Kelantan,0,0,0
2021,ARG,Melaka,0,0,0
2021,ARG,Perak,0,0,0
2021,ARG,Perlis,0,0,0
2021,ARG,Pulau Pinang,0,0,0
2021,ARG,Sabah,0,0,0
2021,ARG,Sarawak,0,0,0
2021,ARG,Selangor,95,57,38
2021,ARG,W.P. Labuan,0,0,0
2021,ARM,Johor,0,0,0
2021,ARM,Kedah,0,0,0
2021,ARM,Kelantan,0,0,0
2021,ARM,Perak,0,0,0
2021,ARM,Perlis,0,0,0
2021,ARM,Pulau Pinang,1,0,1
2021,ARM,Sabah,0,0,0
2021,ARM,Sarawak,0,0,0
2021,ARM,Selangor,7,3,4
2021,ATA,Selangor,0,0,0
2021,ATG,Johor,0,0,0
2021,ATG,Kedah,0,0,0
2021,ATG,Pulau Pinang,0,0,0
2021,ATG,Sarawak,0,0,0
2021,ATG,Selangor,2,1,1
2021,AUS,Johor,22,15,7
2021,AUS,Kedah,23,13,10
2021,AUS,Kelantan,0,0,0
2021,AUS,Melaka,0,0,0
2021,AUS,Negeri Sembilan,0,0,0
2021,AUS,Pahang,0,0,0
2021,AUS,Perak,4,3,1
2021,AUS,Perlis,0,0,0
2021,AUS,Pulau Pinang,83,45,38
2021,AUS,Sabah,8,6,2
2021,AUS,Sarawak,13,11,2
2021,AUS,Selangor,1747,1141,606
2021,AUS,Terengganu,0,0,0
2021,AUS,W.P. Labuan,0,0,0
2021,AUT,Johor,0,0,0
2021,AUT,Kedah,0,0,0
2021,AUT,Kelantan,1,1,0
2021,AUT,Melaka,0,0,0
2021,AUT,Negeri Sembilan,0,0,0
2021,AUT,Pahang,0,0,0
2021,AUT,Perak,0,0,0
2021,AUT,Perlis,0,0,0
2021,AUT,Pulau Pinang,4,1,3
2021,AUT,Sabah,0,0,0
2021,AUT,Sarawak,4,4,0
2021,AUT,Selangor,218,174,44
2021,AUT,Terengganu,0,0,0
2021,AUT,W.P. Labuan,0,0,0
2021,AZE,Johor,0,0,0
2021,AZE,Kedah,0,0,0
2021,AZE,Kelantan,0,0,0
2021,AZE,Melaka,0,0,0
2021,AZE,Perlis,0,0,0
2021,AZE,Pulau Pinang,0,0,0
2021,AZE,Sabah,0,0,0
2021,AZE,Sarawak,0,0,0
2021,AZE,Selangor,43,26,17
2021,AZE,W.P. Labuan,0,0,0
2021,BDI,Pulau Pinang,0,0,0
2021,BDI,Sarawak,0,0,0
2021,BDI,Selangor,12,5,7
2021,BEL,Johor,1,1,0
2021,BEL,Kedah,1,1,0
2021,BEL,Kelantan,0,0,0
2021,BEL,Melaka,0,0,0
2021,BEL,Negeri Sembilan,0,0,0
2021,BEL,Pahang,0,0,0
2021,BEL,Perak,0,0,0
2021,BEL,Perlis,0,0,0
2021,BEL,Pulau Pinang,9,6,3
2021,BEL,Sabah,0,0,0
2021,BEL,Sarawak,2,2,0
2021,BEL,Selangor,237,173,64
2021,BEL,W.P. Labuan,0,0,0
2021,BEN,Johor,0,0,0
2021,BEN,Kedah,0,0,0
2021,BEN,Perak,0,0,0
2021,BEN,Pulau Pinang,0,0,0
2021,BEN,Sabah,0,0,0
2021,BEN,Sarawak,0,0,0
2021,BEN,Selangor,2,2,0
2021,BFA,Perak,0,0,0
2021,BFA,Pulau Pinang,0,0,0
2021,BFA,Selangor,2,1,1
2021,BGD,Johor,39,36,3
2021,BGD,Kedah,0,0,0
2021,BGD,Kelantan,0,0,0
2021,BGD,Melaka,0,0,0
2021,BGD,Negeri Sembilan,0,0,0
2021,BGD,Pahang,0,0,0
2021,BGD,Perak,0,0,0
2021,BGD,Perlis,0,0,0
2021,BGD,Pulau Pinang,3,3,0
2021,BGD,Sabah,0,0,0
2021,BGD,Sarawak,2,2,0
2021,BGD,Selangor,8017,7226,791
2021,BGD,W.P. Labuan,0,0,0
2021,BGR,Johor,0,0,0
2021,BGR,Kedah,0,0,0
2021,BGR,Kelantan,0,0,0
2021,BGR,Pahang,0,0,0
2021,BGR,Perak,0,0,0
2021,BGR,Perlis,0,0,0
2021,BGR,Pulau Pinang,0,0,0
2021,BGR,Sabah,0,0,0
2021,BGR,Sarawak,0,0,0
2021,BGR,Selangor,147,135,12
2021,BGR,W.P. Labuan,0,0,0
2021,BHR,Johor,0,0,0
2021,BHR,Kedah,0,0,0
2021,BHR,Kelantan,0,0,0
2021,BHR,Perlis,0,0,0
2021,BHR,Pulau Pinang,0,0,0
2021,BHR,Sabah,0,0,0
2021,BHR,Sarawak,0,0,0
2021,BHR,Selangor,27,17,10
2021,BHS,Johor,0,0,0
2021,BHS,Kedah,0,0,0
2021,BHS,Perak,0,0,0
2021,BHS,Sabah,0,0,0
2021,BHS,Sarawak,0,0,0
2021,BHS,Selangor,0,0,0
2021,BIH,Johor,0,0,0
2021,BIH,Kedah,0,0,0
2021,BIH,Perlis,0,0,0
2021,BIH,Pulau Pinang,0,0,0
2021,BIH,Sabah,0,0,0
2021,BIH,Sarawak,1,1,0
2021,BIH,Selangor,55,29,26
2021,BLR,Johor,0,0,0
2021,BLR,Kedah,0,0,0
2021,BLR,Kelantan,0,0,0
2021,BLR,Pahang,0,0,0
2021,BLR,Perak,0,0,0
2021,BLR,Perlis,0,0,0
2021,BLR,Pulau Pinang,0,0,0
2021,BLR,Sabah,0,0,0
2021,BLR,Sarawak,0,0,0
2021,BLR,Selangor,12,8,4
2021,BLR,W.P. Labuan,0,0,0
2021,BLZ,Johor,0,0,0
2021,BLZ,Pulau Pinang,0,0,0
2021,BLZ,Sarawak,0,0,0
2021,BLZ,Selangor,6,2,4
2021,BMU,Selangor,0,0,0
2021,BOL,Johor,0,0,0
2021,BOL,Kedah,0,0,0
2021,BOL,Melaka,0,0,0
2021,BOL,Perak,0,0,0
2021,BOL,Perlis,0,0,0
2021,BOL,Pulau Pinang,0,0,0
2021,BOL,Sabah,0,0,0
2021,BOL,Sarawak,0,0,0
2021,BOL,Selangor,2,1,1
2021,BRA,Johor,14,14,0
2021,BRA,Kedah,1,0,1
2021,BRA,Kelantan,0,0,0
2021,BRA,Melaka,0,0,0
2021,BRA,Pahang,0,0,0
2021,BRA,Perak,0,0,0
2021,BRA,Perlis,0,0,0
2021,BRA,Pulau Pinang,0,0,0
2021,BRA,Sabah,2,2,0
2021,BRA,Sarawak,3,2,1
2021,BRA,Selangor,284,185,99
2021,BRA,W.P. Labuan,0,0,0
2021,BRB,Johor,0,0,0
2021,BRB,Kedah,0,0,0
2021,BRB,Perlis,0,0,0
2021,BRB,Pulau Pinang,0,0,0
2021,BRB,Selangor,5,4,1
2021,BRN,Johor,2,1,1
2021,BRN,Kedah,2,2,0
2021,BRN,Kelantan,0,0,0
2021,BRN,Melaka,0,0,0
2021,BRN,Pahang,0,0,0
2021,BRN,Perak,0,0,0
2021,BRN,Perlis,0,0,0
2021,BRN,Pulau Pinang,0,0,0
2021,BRN,Sabah,0,0,0
2021,BRN,Sarawak,3822,3745,77
2021,BRN,Selangor,325,175,150
2021,BRN,W.P. Labuan,11,10,1
2021,BTN,Johor,0,0,0
2021,BTN,Kedah,0,0,0
2021,BTN,Perak,0,0,0
2021,BTN,Perlis,0,0,0
2021,BTN,Pulau Pinang,0,0,0
2021,BTN,Sabah,0,0,0
2021,BTN,Sarawak,0,0,0
2021,BTN,Selangor,17,13,4
2021,BWA,Johor,0,0,0
2021,BWA,Kedah,0,0,0
2021,BWA,Perlis,0,0,0
2021,BWA,Pulau Pinang,0,0,0
2021,BWA,Sabah,0,0,0
2021,BWA,Sarawak,0,0,0
2021,BWA,Selangor,9,6,3
2021,CAF,Kedah,0,0,0
2021,CAF,Selangor,2,2,0
2021,CAN,Johor,3,3,0
2021,CAN,Kedah,2,2,0
2021,CAN,Kelantan,0,0,0
2021,CAN,Melaka,0,0,0
2021,CAN,Negeri Sembilan,0,0,0
2021,CAN,Pahang,0,0,0
2021,CAN,Perak,0,0,0
2021,CAN,Perlis,0,0,0
2021,CAN,Pulau Pinang,9,4,5
2021,CAN,Sabah,0,0,0
2021,CAN,Sarawak,3,3,0
2021,CAN,Selangor,787,515,272
2021,CAN,Terengganu,0,0,0
2021,CAN,W.P. Labuan,0,0,0
2021,CCK,Selangor,0,0,0
2021,CHE,Johor,1,0,1
2021,CHE,Kedah,1,1,0
2021,CHE,Kelantan,0,0,0
2021,CHE,Melaka,0,0,0
2021,CHE,Negeri Sembilan,0,0,0
2021,CHE,Pahang,0,0,0
2021,CHE,Perak,0,0,0
2021,CHE,Perlis,0,0,0
2021,CHE,Pulau Pinang,16,7,9
2021,CHE,Sabah,0,0,0
2021,CHE,Sarawak,0,0,0
2021,CHE,Selangor,271,185,86
2021,CHE,W.P. Labuan,0,0,0
2021,CHL,Johor,0,0,0
2021,CHL,Kedah,0,0,0
2021,CHL,Kelantan,0,0,0
2021,CHL,Melaka,0,0,0
2021,CHL,Pahang,0,0,0
2021,CHL,Perak,0,0,0
2021,CHL,Perlis,0,0,0
2021,CHL,Pulau Pinang,0,0,0
2021,CHL,Sabah,1,1,0
2021,CHL,Sarawak,0,0,0
2021,CHL,Selangor,36,20,16
2021,CHN,Johor,302,270,32
2021,CHN,Kedah,8,5,3
2021,CHN,Kelantan,0,0,0
2021,CHN,Melaka,0,0,0
2021,CHN,Pahang,1,1,0
2021,CHN,Perak,0,0,0
2021,CHN,Perlis,0,0,0
2021,CHN,Pulau Pinang,55,29,26
2021,CHN,Sabah,21,15,6
2021,CHN,Sarawak,1205,1137,68
2021,CHN,Selangor,13963,10894,3069
2021,CHN,Terengganu,0,0,0
2021,CHN,W.P. Labuan,0,0,0
2021,CIV,Johor,0,0,0
2021,CIV,Kedah,0,0,0
2021,CIV,Pulau Pinang,0,0,0
2021,CIV,Sabah,0,0,0
2021,CIV,Sarawak,0,0,0
2021,CIV,Selangor,12,9,3
2021,CMR,Johor,0,0,0
2021,CMR,Kedah,0,0,0
2021,CMR,Pulau Pinang,0,0,0
2021,CMR,Sabah,0,0,0
2021,CMR,Sarawak,0,0,0
2021,CMR,Selangor,25,16,9
2021,COD,Johor,0,0,0
2021,COD,Pulau Pinang,0,0,0
2021,COD,Sarawak,0,0,0
2021,COD,Selangor,15,10,5
2021,COG,Johor,0,0,0
2021,COG,Kedah,0,0,0
2021,COG,Selangor,1,1,0
2021,COK,Selangor,0,0,0
2021,COL,Johor,0,0,0
2021,COL,Kedah,0,0,0
2021,COL,Perak,0,0,0
2021,COL,Pulau Pinang,1,0,1
2021,COL,Sabah,0,0,0
2021,COL,Sarawak,0,0,0
2021,COL,Selangor,75,38,37
2021,COL,W.P. Labuan,0,0,0
2021,COM,Johor,0,0,0
2021,COM,Kedah,0,0,0
2021,COM,Selangor,24,15,9
2021,CPV,Johor,0,0,0
2021,CPV,Kedah,0,0,0
2021,CPV,Pulau Pinang,0,0,0
2021,CPV,Sabah,0,0,0
2021,CPV,Selangor,0,0,0
2021,CRI,Johor,0,0,0
2021,CRI,Kedah,0,0,0
2021,CRI,Perak,0,0,0
2021,CRI,Perlis,0,0,0
2021,CRI,Pulau Pinang,0,0,0
2021,CRI,Sabah,0,0,0
2021,CRI,Sarawak,0,0,0
2021,CRI,Selangor,91,61,30
2021,CUB,Johor,0,0,0
2021,CUB,Kedah,0,0,0
2021,CUB,Perlis,0,0,0
2021,CUB,Pulau Pinang,0,0,0
2021,CUB,Sabah,0,0,0
2021,CUB,Sarawak,0,0,0
2021,CUB,Selangor,4,2,2
2021,CYP,Johor,0,0,0
2021,CYP,Kedah,0,0,0
2021,CYP,Perak,0,0,0
2021,CYP,Perlis,0,0,0
2021,CYP,Pulau Pinang,0,0,0
2021,CYP,Sabah,0,0,0
2021,CYP,Sarawak,0,0,0
2021,CYP,Selangor,8,6,2
2021,CZE,Johor,2,2,0
2021,CZE,Kedah,0,0,0
2021,CZE,Kelantan,0,0,0
2021,CZE,Melaka,0,0,0
2021,CZE,Negeri Sembilan,0,0,0
2021,CZE,Perak,0,0,0
2021,CZE,Perlis,0,0,0
2021,CZE,Pulau Pinang,0,0,0
2021,CZE,Sabah,0,0,0
2021,CZE,Sarawak,0,0,0
2021,CZE,Selangor,86,65,21
2021,CZE,W.P. Labuan,0,0,0
2021,DEU,Johor,9,9,0
2021,DEU,Kedah,8,5,3
2021,DEU,Kelantan,0,0,0
2021,DEU,Melaka,0,0,0
2021,DEU,Negeri Sembilan,0,0,0
2021,DEU,Pahang,0,0,0
2021,DEU,Perak,1,1,0
2021,DEU,Perlis,0,0,0
2021,DEU,Pulau Pinang,40,31,9
2021,DEU,Sabah,1,1,0
2021,DEU,Sarawak,13,11,2
2021,DEU,Selangor,1440,1126,314
2021,DEU,Terengganu,0,0,0
2021,DEU,W.P. Labuan,0,0,0
2021,DJI,Johor,0,0,0
2021,DJI,Selangor,51,20,31
2021,DMA,Johor,0,0,0
2021,DMA,Kedah,0,0,0
2021,DMA,Pulau Pinang,0,0,0
2021,DMA,Sabah,0,0,0
2021,DMA,Sarawak,0,0,0
2021,DMA,Selangor,20,14,6
2021,DMA,W.P. Labuan,0,0,0
2021,DNK,Johor,22,20,2
2021,DNK,Kedah,1,1,0
2021,DNK,Kelantan,0,0,0
2021,DNK,Melaka,0,0,0
2021,DNK,Negeri Sembilan,0,0,0
2021,DNK,Pahang,0,0,0
2021,DNK,Perak,0,0,0
2021,DNK,Perlis,0,0,0
2021,DNK,Pulau Pinang,14,12,2
2021,DNK,Sabah,0,0,0
2021,DNK,Sarawak,2,2,0
2021,DNK,Selangor,292,231,61
2021,DNK,W.P. Labuan,0,0,0
2021,DOM,Johor,0,0,0
2021,DOM,Kedah,0,0,0
2021,DOM,Perak,0,0,0
2021,DOM,Perlis,0,0,0
2021,DOM,Pulau Pinang,0,0,0
2021,DOM,Sabah,0,0,0
2021,DOM,Sarawak,0,0,0
2021,DOM,Selangor,1,1,0
2021,DZA,Johor,0,0,0
2021,DZA,Kedah,0,0,0
2021,DZA,Kelantan,0,0,0
2021,DZA,Melaka,0,0,0
2021,DZA,Perak,0,0,0
2021,DZA,Perlis,0,0,0
2021,DZA,Pulau Pinang,0,0,0
2021,DZA,Sabah,0,0,0
2021,DZA,Sarawak,0,0,0
2021,DZA,Selangor,158,103,55
2021,DZA,W.P. Labuan,0,0,0
2021,ECU,Johor,0,0,0
2021,ECU,Kedah,0,0,0
2021,ECU,Perak,0,0,0
2021,ECU,Perlis,0,0,0
2021,ECU,Pulau Pinang,0,0,0
2021,ECU,Sabah,0,0,0
2021,ECU,Sarawak,0,0,0
2021,ECU,Selangor,8,7,1
2021,EGY,Johor,1,1,0
2021,EGY,Kedah,0,0,0
2021,EGY,Kelantan,0,0,0
2021,EGY,Melaka,0,0,0
2021,EGY,Pahang,0,0,0
2021,EGY,Perak,0,0,0
2021,EGY,Perlis,0,0,0
2021,EGY,Pulau Pinang,0,0,0
2021,EGY,Sabah,1,1,0
2021,EGY,Sarawak,1,1,0
2021,EGY,Selangor,1286,972,314
2021,EGY,Terengganu,0,0,0
2021,EGY,W.P. Labuan,0,0,0
2021,ERI,Johor,0,0,0
2021,ERI,Pulau Pinang,0,0,0
2021,ERI,Sabah,0,0,0
2021,ERI,Selangor,14,8,6
2021,ESP,Johor,4,4,0
2021,ESP,Kedah,0,0,0
2021,ESP,Kelantan,0,0,0
2021,ESP,Melaka,0,0,0
2021,ESP,Negeri Sembilan,0,0,0
2021,ESP,Pahang,0,0,0
2021,ESP,Perak,0,0,0
2021,ESP,Perlis,0,0,0
2021,ESP,Pulau Pinang,3,2,1
2021,ESP,Sabah,1,1,0
2021,ESP,Sarawak,0,0,0
2021,ESP,Selangor,376,263,113
2021,ESP,W.P. Labuan,0,0,0
2021,EST,Johor,0,0,0
2021,EST,Kedah,1,1,0
2021,EST,Kelantan,0,0,0
2021,EST,Pahang,0,0,0
2021,EST,Perak,0,0,0
2021,EST,Perlis,0,0,0
2021,EST,Pulau Pinang,0,0,0
2021,EST,Sabah,0,0,0
2021,EST,Sarawak,0,0,0
2021,EST,Selangor,26,21,5
2021,EST,W.P. Labuan,0,0,0
2021,ETH,Johor,4,4,0
2021,ETH,Kedah,0,0,0
2021,ETH,Pulau Pinang,0,0,0
2021,ETH,Sarawak,1,0,1
2021,ETH,Selangor,46,25,21
2021,FIN,Johor,2,2,0
2021,FIN,Kedah,0,0,0
2021,FIN,Kelantan,0,0,0
2021,FIN,Melaka,0,0,0
2021,FIN,Negeri Sembilan,0,0,0
2021,FIN,Pahang,0,0,0
2021,FIN,Perak,0,0,0
2021,FIN,Perlis,0,0,0
2021,FIN,Pulau Pinang,1,1,0
2021,FIN,Sabah,0,0,0
2021,FIN,Sarawak,0,0,0
2021,FIN,Selangor,180,139,41
2021,FIN,W.P. Labuan,0,0,0
2021,FJI,Johor,0,0,0
2021,FJI,Kedah,0,0,0
2021,FJI,Kelantan,0,0,0
2021,FJI,Perak,0,0,0
2021,FJI,Perlis,0,0,0
2021,FJI,Pulau Pinang,0,0,0
2021,FJI,Sabah,0,0,0
2021,FJI,Sarawak,0,0,0
2021,FJI,Selangor,10,5,5
2021,FRA,Johor,8,8,0
2021,FRA,Kedah,3,2,1
2021,FRA,Kelantan,0,0,0
2021,FRA,Melaka,0,0,0
2021,FRA,Negeri Sembilan,0,0,0
2021,FRA,Pahang,0,0,0
2021,FRA,Perak,0,0,0
2021,FRA,Perlis,0,0,0
2021,FRA,Pulau Pinang,26,21,5
2021,FRA,Sabah,0,0,0
2021,FRA,Sarawak,9,9,0
2021,FRA,Selangor,1931,1321,610
2021,FRA,Terengganu,0,0,0
2021,FRA,W.P. Labuan,0,0,0
2021,FSM,Johor,0,0,0
2021,FSM,Pulau Pinang,0,0,0
2021,FSM,Selangor,0,0,0
2021,GAB,Johor,0,0,0
2021,GAB,Pulau Pinang,0,0,0
2021,GAB,Sarawak,0,0,0
2021,GAB,Selangor,8,7,1
2021,GBR,Johor,52,48,4
2021,GBR,Kedah,20,12,8
2021,GBR,Kelantan,0,0,0
2021,GBR,Melaka,0,0,0
2021,GBR,Negeri Sembilan,0,0,0
2021,GBR,Pahang,0,0,0
2021,GBR,Perak,4,0,4
2021,GBR,Perlis,0,0,0
2021,GBR,Pulau Pinang,118,69,49
2021,GBR,Sabah,4,2,2
2021,GBR,Sarawak,28,23,5
2021,GBR,Selangor,4781,3404,1377
2021,GBR,Terengganu,0,0,0
2021,GBR,W.P. Labuan,0,0,0
2021,GEO,Johor,3,3,0
2021,GEO,Kedah,0,0,0
2021,GEO,Melaka,0,0,0
2021,GEO,Perak,0,0,0
2021,GEO,Perlis,0,0,0
2021,GEO,Pulau Pinang,0,0,0
2021,GEO,Sabah,0,0,0
2021,GEO,Sarawak,0,0,0
2021,GEO,Selangor,42,39,3
2021,GHA,Johor,1,1,0
2021,GHA,Kedah,0,0,0
2021,GHA,Kelantan,0,0,0
2021,GHA,Pulau Pinang,0,0,0
2021,GHA,Sabah,1,1,0
2021,GHA,Sarawak,0,0,0
2021,GHA,Selangor,82,61,21
2021,GIB,Johor,0,0,0
2021,GIB,Sarawak,0,0,0
2021,GIN,Johor,0,0,0
2021,GIN,Kedah,0,0,0
2021,GIN,Kelantan,0,0,0
2021,GIN,Perlis,0,0,0
2021,GIN,Pulau Pinang,0,0,0
2021,GIN,Sabah,0,0,0
2021,GIN,Sarawak,0,0,0
2021,GIN,Selangor,94,53,41
2021,GLP,Selangor,0,0,0
2021,GMB,Johor,0,0,0
2021,GMB,Kedah,0,0,0
2021,GMB,Kelantan,0,0,0
2021,GMB,Pulau Pinang,0,0,0
2021,GMB,Sabah,0,0,0
2021,GMB,Sarawak,0,0,0
2021,GMB,Selangor,19,13,6
2021,GNB,Johor,0,0,0
2021,GNB,Selangor,0,0,0
2021,GNQ,Johor,0,0,0
2021,GNQ,Selangor,12,7,5
2021,GRC,Johor,9,8,1
2021,GRC,Kedah,0,0,0
2021,GRC,Kelantan,0,0,0
2021,GRC,Melaka,0,0,0
2021,GRC,Negeri Sembilan,0,0,0
2021,GRC,Pahang,0,0,0
2021,GRC,Perak,0,0,0
2021,GRC,Perlis,0,0,0
2021,GRC,Pulau Pinang,0,0,0
2021,GRC,Sabah,0,0,0
2021,GRC,Sarawak,0,0,0
2021,GRC,Selangor,99,89,10
2021,GRD,Johor,0,0,0
2021,GRD,Kedah,0,0,0
2021,GRD,Pulau Pinang,0,0,0
2021,GRD,Sabah,0,0,0
2021,GRD,Sarawak,0,0,0
2021,GRD,Selangor,4,2,2
2021,GRL,Johor,0,0,0
2021,GRL,Selangor,0,0,0
2021,GTM,Johor,0,0,0
2021,GTM,Kedah,0,0,0
2021,GTM,Pahang,0,0,0
2021,GTM,Perak,0,0,0
2021,GTM,Pulau Pinang,0,0,0
2021,GTM,Sabah,0,0,0
2021,GTM,Sarawak,0,0,0
2021,GTM,Selangor,3,3,0
2021,GTM,W.P. Labuan,0,0,0
2021,GUY,Johor,0,0,0
2021,GUY,Kedah,0,0,0
2021,GUY,Pulau Pinang,0,0,0
2021,GUY,Sarawak,0,0,0
2021,GUY,Selangor,0,0,0
2021,HKG,Johor,0,0,0
2021,HKG,Kedah,0,0,0
2021,HKG,Kelantan,0,0,0
2021,HKG,Pahang,0,0,0
2021,HKG,Perak,1,0,1
2021,HKG,Perlis,0,0,0
2021,HKG,Pulau Pinang,29,16,13
2021,HKG,Sabah,0,0,0
2021,HKG,Sarawak,129,117,12
2021,HKG,Selangor,15,14,1
2021,HKG,Terengganu,0,0,0
2021,HMD,Johor,0,0,0
2021,HND,Johor,0,0,0
2021,HND,Kedah,0,0,0
2021,HND,Perak,0,0,0
2021,HND,Pulau Pinang,0,0,0
2021,HND,Sabah,0,0,0
2021,HND,Sarawak,0,0,0
2021,HND,Selangor,13,11,2
2021,HRV,Johor,20,20,0
2021,HRV,Kedah,0,0,0
2021,HRV,Kelantan,0,0,0
2021,HRV,Melaka,0,0,0
2021,HRV,Pahang,0,0,0
2021,HRV,Perak,0,0,0
2021,HRV,Perlis,0,0,0
2021,HRV,Pulau Pinang,0,0,0
2021,HRV,Sabah,2,2,0
2021,HRV,Sarawak,1,1,0
2021,HRV,Selangor,318,302,16
2021,HTI,Johor,0,0,0
2021,HTI,Kedah,0,0,0
2021,HTI,Kelantan,0,0,0
2021,HTI,Perak,0,0,0
2021,HTI,Pulau Pinang,0,0,0
2021,HTI,Sabah,0,0,0
2021,HTI,Selangor,1,1,0
2021,HUN,Johor,0,0,0
2021,HUN,Kedah,0,0,0
2021,HUN,Kelantan,0,0,0
2021,HUN,Pahang,0,0,0
2021,HUN,Perak,0,0,0
2021,HUN,Perlis,0,0,0
2021,HUN,Pulau Pinang,2,0,2
2021,HUN,Sabah,0,0,0
2021,HUN,Sarawak,0,0,0
2021,HUN,Selangor,92,56,36
2021,HUN,W.P. Labuan,0,0,0
2021,IDN,Johor,1959,1444,515
2021,IDN,Kedah,72,63,9
2021,IDN,Kelantan,0,0,0
2021,IDN,Melaka,4,1,3
2021,IDN,Negeri Sembilan,0,0,0
2021,IDN,Pahang,1,1,0
2021,IDN,Perak,2,0,2
2021,IDN,Perlis,62,61,1
2021,IDN,Pulau Pinang,265,99,166
2021,IDN,Sabah,37,15,22
2021,IDN,Sarawak,3437,3380,57
2021,IDN,Selangor,14181,7979,6202
2021,IDN,Terengganu,5,5,0
2021,IDN,W.P. Labuan,23,21,2
2021,IND,Johor,432,424,8
2021,IND,Kedah,1,1,0
2021,IND,Kelantan,0,0,0
2021,IND,Melaka,0,0,0
2021,IND,Negeri Sembilan,0,0,0
2021,IND,Pahang,2,2,0
2021,IND,Perak,0,0,0
2021,IND,Perlis,0,0,0
2021,IND,Pulau Pinang,25,20,5
2021,IND,Sabah,8,7,1
2021,IND,Sarawak,7,7,0
2021,IND,Selangor,14010,10420,3590
2021,IND,Terengganu,0,0,0
2021,IND,W.P. Labuan,0,0,0
2021,IOT,Pulau Pinang,0,0,0
2021,IOT,Selangor,0,0,0
2021,IRL,Johor,1,1,0
2021,IRL,Kedah,0,0,0
2021,IRL,Kelantan,0,0,0
2021,IRL,Negeri Sembilan,0,0,0
2021,IRL,Pahang,0,0,0
2021,IRL,Perak,0,0,0
2021,IRL,Perlis,0,0,0
2021,IRL,Pulau Pinang,2,2,0
2021,IRL,Sabah,0,0,0
2021,IRL,Sarawak,1,1,0
2021,IRL,Selangor,242,159,83
2021,IRL,Terengganu,0,0,0
2021,IRL,W.P. Labuan,0,0,0
2021,IRN,Johor,3,3,0
2021,IRN,Kedah,0,0,0
2021,IRN,Kelantan,0,0,0
2021,IRN,Perak,0,0,0
2021,IRN,Perlis,0,0,0
2021,IRN,Pulau Pinang,1,0,1
2021,IRN,Sabah,0,0,0
2021,IRN,Sarawak,0,0,0
2021,IRN,Selangor,755,481,274
2021,IRN,W.P. Labuan,0,0,0
2021,IRQ,Johor,0,0,0
2021,IRQ,Kedah,0,0,0
2021,IRQ,Kelantan,0,0,0
2021,IRQ,Melaka,0,0,0
2021,IRQ,Pahang,0,0,0
2021,IRQ,Perak,0,0,0
2021,IRQ,Perlis,0,0,0
2021,IRQ,Pulau Pinang,0,0,0
2021,IRQ,Sabah,0,0,0
2021,IRQ,Sarawak,0,0,0
2021,IRQ,Selangor,702,479,223
2021,ISL,Johor,0,0,0
2021,ISL,Kedah,0,0,0
2021,ISL,Kelantan,0,0,0
2021,ISL,Perak,0,0,0
2021,ISL,Perlis,0,0,0
2021,ISL,Pulau Pinang,0,0,0
2021,ISL,Sabah,0,0,0
2021,ISL,Sarawak,0,0,0
2021,ISL,Selangor,4,3,1
2021,ISL,W.P. Labuan,0,0,0
2021,ISR,Pulau Pinang,0,0,0
2021,ITA,Johor,1,1,0
2021,ITA,Kedah,6,5,1
2021,ITA,Kelantan,0,0,0
2021,ITA,Melaka,0,0,0
2021,ITA,Negeri Sembilan,0,0,0
2021,ITA,Pahang,0,0,0
2021,ITA,Perak,0,0,0
2021,ITA,Perlis,0,0,0
2021,ITA,Pulau Pinang,6,6,0
2021,ITA,Sabah,1,1,0
2021,ITA,Sarawak,5,5,0
2021,ITA,Selangor,675,542,133
2021,ITA,W.P. Labuan,0,0,0
2021,JAM,Johor,0,0,0
2021,JAM,Kedah,0,0,0
2021,JAM,Perak,0,0,0
2021,JAM,Pulau Pinang,0,0,0
2021,JAM,Sabah,0,0,0
2021,JAM,Sarawak,0,0,0
2021,JAM,Selangor,6,3,3
2021,JAM,W.P. Labuan,0,0,0
2021,JOR,Johor,0,0,0
2021,JOR,Kedah,0,0,0
2021,JOR,Kelantan,0,0,0
2021,JOR,Melaka,0,0,0
2021,JOR,Perlis,0,0,0
2021,JOR,Pulau Pinang,0,0,0
2021,JOR,Sabah,0,0,0
2021,JOR,Sarawak,1,1,0
2021,JOR,Selangor,422,322,100
2021,JOR,W.P. Labuan,0,0,0
2021,JPN,Johor,14,12,2
2021,JPN,Kedah,7,1,6
2021,JPN,Kelantan,0,0,0
2021,JPN,Melaka,0,0,0
2021,JPN,Negeri Sembilan,0,0,0
2021,JPN,Pahang,0,0,0
2021,JPN,Perak,6,4,2
2021,JPN,Perlis,0,0,0
2021,JPN,Pulau Pinang,370,244,126
2021,JPN,Sabah,5,2,3
2021,JPN,Sarawak,58,54,4
2021,JPN,Selangor,6357,4151,2206
2021,JPN,W.P. Labuan,0,0,0
2021,KAZ,Johor,0,0,0
2021,KAZ,Kedah,0,0,0
2021,KAZ,Kelantan,0,0,0
2021,KAZ,Melaka,0,0,0
2021,KAZ,Perak,0,0,0
2021,KAZ,Perlis,0,0,0
2021,KAZ,Pulau Pinang,0,0,0
2021,KAZ,Sabah,0,0,0
2021,KAZ,Sarawak,0,0,0
2021,KAZ,Selangor,242,122,120
2021,KAZ,W.P. Labuan,0,0,0
2021,KEN,Johor,0,0,0
2021,KEN,Kedah,0,0,0
2021,KEN,Kelantan,0,0,0
2021,KEN,Perak,0,0,0
2021,KEN,Perlis,0,0,0
2021,KEN,Pulau Pinang,0,0,0
2021,KEN,Sabah,0,0,0
2021,KEN,Sarawak,0,0,0
2021,KEN,Selangor,258,157,101
2021,KGZ,Johor,0,0,0
2021,KGZ,Kedah,0,0,0
2021,KGZ,Kelantan,0,0,0
2021,KGZ,Perak,0,0,0
2021,KGZ,Perlis,0,0,0
2021,KGZ,Pulau Pinang,0,0,0
2021,KGZ,Sabah,0,0,0
2021,KGZ,Sarawak,0,0,0
2021,KGZ,Selangor,59,33,26
2021,KHM,Johor,0,0,0
2021,KHM,Kedah,0,0,0
2021,KHM,Kelantan,0,0,0
2021,KHM,Melaka,0,0,0
2021,KHM,Negeri Sembilan,0,0,0
2021,KHM,Pahang,0,0,0
2021,KHM,Perak,1,0,1
2021,KHM,Perlis,0,0,0
2021,KHM,Pulau Pinang,38,34,4
2021,KHM,Sabah,0,0,0
2021,KHM,Sarawak,1,1,0
2021,KHM,Selangor,363,290,73
2021,KHM,W.P. Labuan,0,0,0
2021,KIR,Johor,11,11,0
2021,KIR,Sabah,0,0,0
2021,KIR,Selangor,29,29,0
2021,KNA,Johor,0,0,0
2021,KNA,Kedah,0,0,0
2021,KNA,Perlis,0,0,0
2021,KNA,Pulau Pinang,0,0,0
2021,KNA,Sabah,0,0,0
2021,KNA,Selangor,6,5,1
2021,KNA,W.P. Labuan,0,0,0
2021,KOR,Johor,14,13,1
2021,KOR,Kedah,0,0,0
2021,KOR,Kelantan,0,0,0
2021,KOR,Melaka,0,0,0
2021,KOR,Negeri Sembilan,0,0,0
2021,KOR,Pahang,0,0,0
2021,KOR,Perak,2,2,0
2021,KOR,Perlis,0,0,0
2021,KOR,Pulau Pinang,111,46,65
2021,KOR,Sabah,12,7,5
2021,KOR,Sarawak,245,220,25
2021,KOR,Selangor,4964,3258,1706
2021,KOR,Terengganu,0,0,0
2021,KOR,W.P. Labuan,0,0,0
2021,KWT,Johor,0,0,0
2021,KWT,Kedah,0,0,0
2021,KWT,Kelantan,0,0,0
2021,KWT,Perak,0,0,0
2021,KWT,Perlis,0,0,0
2021,KWT,Pulau Pinang,0,0,0
2021,KWT,Sabah,0,0,0
2021,KWT,Sarawak,0,0,0
2021,KWT,Selangor,58,39,19
2021,KWT,W.P. Labuan,0,0,0
2021,LAO,Johor,0,0,0
2021,LAO,Kedah,1,0,1
2021,LAO,Kelantan,0,0,0
2021,LAO,Melaka,0,0,0
2021,LAO,Perak,0,0,0
2021,LAO,Perlis,0,0,0
2021,LAO,Pulau Pinang,0,0,0
2021,LAO,Sabah,0,0,0
2021,LAO,Sarawak,0,0,0
2021,LAO,Selangor,553,537,16
2021,LAO,W.P. Labuan,0,0,0
2021,LBN,Johor,0,0,0
2021,LBN,Kedah,0,0,0
2021,LBN,Kelantan,0,0,0
2021,LBN,Pahang,0,0,0
2021,LBN,Perak,0,0,0
2021,LBN,Perlis,0,0,0
2021,LBN,Pulau Pinang,0,0,0
2021,LBN,Sabah,0,0,0
2021,LBN,Sarawak,0,0,0
2021,LBN,Selangor,73,48,25
2021,LBN,W.P. Labuan,0,0,0
2021,LBR,Johor,0,0,0
2021,LBR,Kedah,0,0,0
2021,LBR,Sabah,0,0,0
2021,LBR,Sarawak,0,0,0
2021,LBR,Selangor,23,18,5
2021,LBY,Johor,0,0,0
2021,LBY,Kedah,0,0,0
2021,LBY,Perlis,0,0,0
2021,LBY,Pulau Pinang,0,0,0
2021,LBY,Sabah,0,0,0
2021,LBY,Sarawak,0,0,0
2021,LBY,Selangor,609,465,144
2021,LCA,Johor,0,0,0
2021,LCA,Kedah,0,0,0
2021,LCA,Pulau Pinang,0,0,0
2021,LCA,Sarawak,0,0,0
2021,LCA,Selangor,3,3,0
2021,LIE,Johor,0,0,0
2021,LIE,Kedah,0,0,0
2021,LIE,Perlis,0,0,0
2021,LIE,Pulau Pinang,0,0,0
2021,LIE,Sabah,0,0,0
2021,LIE,Sarawak,0,0,0
2021,LIE,Selangor,3,3,0
2021,LKA,Johor,15,15,0
2021,LKA,Kedah,0,0,0
2021,LKA,Kelantan,0,0,0
2021,LKA,Melaka,0,0,0
2021,LKA,Pahang,0,0,0
2021,LKA,Perak,0,0,0
2021,LKA,Perlis,0,0,0
2021,LKA,Pulau Pinang,1,0,1
2021,LKA,Sabah,1,1,0
2021,LKA,Sarawak,2,2,0
2021,LKA,Selangor,811,493,318
2021,LKA,W.P. Labuan,0,0,0
2021,LSO,Johor,0,0,0
2021,LSO,Kedah,0,0,0
2021,LSO,Pulau Pinang,0,0,0
2021,LSO,Sarawak,0,0,0
2021,LSO,Selangor,2,1,1
2021,LTU,Johor,5,4,1
2021,LTU,Kedah,0,0,0
2021,LTU,Kelantan,0,0,0
2021,LTU,Pahang,0,0,0
2021,LTU,Perak,0,0,0
2021,LTU,Perlis,0,0,0
2021,LTU,Pulau Pinang,0,0,0
2021,LTU,Sabah,0,0,0
2021,LTU,Sarawak,1,1,0
2021,LTU,Selangor,57,45,12
2021,LTU,W.P. Labuan,0,0,0
2021,LUX,Johor,0,0,0
2021,LUX,Kedah,0,0,0
2021,LUX,Kelantan,0,0,0
2021,LUX,Perak,0,0,0
2021,LUX,Perlis,0,0,0
2021,LUX,Pulau Pinang,0,0,0
2021,LUX,Sabah,0,0,0
2021,LUX,Sarawak,0,0,0
2021,LUX,Selangor,10,7,3
2021,LVA,Johor,0,0,0
2021,LVA,Kedah,0,0,0
2021,LVA,Kelantan,0,0,0
2021,LVA,Pahang,0,0,0
2021,LVA,Perak,0,0,0
2021,LVA,Perlis,0,0,0
2021,LVA,Pulau Pinang,0,0,0
2021,LVA,Sabah,0,0,0
2021,LVA,Sarawak,0,0,0
2021,LVA,Selangor,48,40,8
2021,LVA,W.P. Labuan,0,0,0
2021,MAC,Johor,0,0,0
2021,MAC,Pahang,0,0,0
2021,MAC,Perak,0,0,0
2021,MAC,Selangor,0,0,0
2021,MAC,W.P. Labuan,0,0,0
2021,MAR,Johor,0,0,0
2021,MAR,Kedah,1,1,0
2021,MAR,Kelantan,0,0,0
2021,MAR,Melaka,0,0,0
2021,MAR,Pahang,0,0,0
2021,MAR,Perak,0,0,0
2021,MAR,Perlis,0,0,0
2021,MAR,Pulau Pinang,0,0,0
2021,MAR,Sabah,0,0,0
2021,MAR,Sarawak,0,0,0
2021,MAR,Selangor,120,53,67
2021,MAR,W.P. Labuan,0,0,0
2021,MCO,Johor,0,0,0
2021,MCO,Kedah,0,0,0
2021,MCO,Sabah,0,0,0
2021,MCO,Selangor,3,0,3
2021,MDA,Johor,0,0,0
2021,MDA,Kedah,0,0,0
2021,MDA,Kelantan,1,1,0
2021,MDA,Negeri Sembilan,0,0,0
2021,MDA,Perlis,0,0,0
2021,MDA,Pulau Pinang,0,0,0
2021,MDA,Sabah,0,0,0
2021,MDA,Sarawak,0,0,0
2021,MDA,Selangor,2,1,1
2021,MDG,Johor,0,0,0
2021,MDG,Kedah,0,0,0
2021,MDG,Perak,0,0,0
2021,MDG,Perlis,0,0,0
2021,MDG,Pulau Pinang,0,0,0
2021,MDG,Sabah,0,0,0
2021,MDG,Sarawak,0,0,0
2021,MDG,Selangor,3,2,1
2021,MDV,Johor,0,0,0
2021,MDV,Kedah,4,3,1
2021,MDV,Kelantan,0,0,0
2021,MDV,Perak,0,0,0
2021,MDV,Perlis,0,0,0
2021,MDV,Pulau Pinang,2,2,0
2021,MDV,Sabah,0,0,0
2021,MDV,Sarawak,0,0,0
2021,MDV,Selangor,942,400,542
2021,MEX,Johor,0,0,0
2021,MEX,Kedah,0,0,0
2021,MEX,Kelantan,0,0,0
2021,MEX,Pahang,0,0,0
2021,MEX,Perak,0,0,0
2021,MEX,Perlis,0,0,0
2021,MEX,Pulau Pinang,2,1,1
2021,MEX,Sabah,0,0,0
2021,MEX,Sarawak,0,0,0
2021,MEX,Selangor,118,84,34
2021,MEX,W.P. Labuan,0,0,0
2021,MHL,Johor,0,0,0
2021,MHL,Kedah,0,0,0
2021,MHL,Perak,0,0,0
2021,MHL,Pulau Pinang,0,0,0
2021,MHL,Sabah,0,0,0
2021,MHL,Selangor,2,2,0
2021,MKD,Johor,0,0,0
2021,MKD,Kedah,0,0,0
2021,MKD,Perak,0,0,0
2021,MKD,Pulau Pinang,0,0,0
2021,MKD,Sabah,0,0,0
2021,MKD,Sarawak,0,0,0
2021,MKD,Selangor,11,7,4
2021,MLI,Johor,0,0,0
2021,MLI,Sabah,1,1,0
2021,MLI,Selangor,18,15,3
2021,MLT,Johor,0,0,0
2021,MLT,Kedah,0,0,0
2021,MLT,Kelantan,0,0,0
2021,MLT,Perak,0,0,0
2021,MLT,Perlis,0,0,0
2021,MLT,Pulau Pinang,0,0,0
2021,MLT,Sabah,0,0,0
2021,MLT,Sarawak,0,0,0
2021,MLT,Selangor,13,11,2
2021,MLT,W.P. Labuan,0,0,0
2021,MMR,Johor,39,38,1
2021,MMR,Kedah,0,0,0
2021,MMR,Kelantan,0,0,0
2021,MMR,Negeri Sembilan,0,0,0
2021,MMR,Pahang,0,0,0
2021,MMR,Perak,0,0,0
2021,MMR,Perlis,0,0,0
2021,MMR,Pulau Pinang,1,0,1
2021,MMR,Sabah,1,1,0
2021,MMR,Sarawak,2,1,1
2021,MMR,Selangor,1615,1412,203
2021,MMR,Terengganu,0,0,0
2021,MMR,W.P. Labuan,0,0,0
2021,MNE,Johor,10,10,0
2021,MNE,Kedah,0,0,0
2021,MNE,Pulau Pinang,0,0,0
2021,MNE,Sabah,0,0,0
2021,MNE,Sarawak,0,0,0
2021,MNE,Selangor,66,65,1
2021,MNG,Johor,0,0,0
2021,MNG,Kedah,0,0,0
2021,MNG,Kelantan,0,0,0
2021,MNG,Perak,0,0,0
2021,MNG,Perlis,0,0,0
2021,MNG,Pulau Pinang,0,0,0
2021,MNG,Sabah,0,0,0
2021,MNG,Sarawak,0,0,0
2021,MNG,Selangor,19,3,16
2021,MNP,Selangor,0,0,0
2021,MOZ,Johor,0,0,0
2021,MOZ,Kedah,0,0,0
2021,MOZ,Perak,0,0,0
2021,MOZ,Pulau Pinang,0,0,0
2021,MOZ,Sabah,0,0,0
2021,MOZ,Sarawak,0,0,0
2021,MOZ,Selangor,51,31,20
2021,MRT,Johor,0,0,0
2021,MRT,Kedah,0,0,0
2021,MRT,Pulau Pinang,0,0,0
2021,MRT,Sabah,0,0,0
2021,MRT,Sarawak,0,0,0
2021,MRT,Selangor,42,36,6
2021,MUS,Johor,0,0,0
2021,MUS,Kedah,0,0,0
2021,MUS,Kelantan,0,0,0
2021,MUS,Pahang,0,0,0
2021,MUS,Perak,0,0,0
2021,MUS,Perlis,0,0,0
2021,MUS,Pulau Pinang,0,0,0
2021,MUS,Sabah,0,0,0
2021,MUS,Sarawak,0,0,0
2021,MUS,Selangor,146,63,83
2021,MWI,Johor,0,0,0
2021,MWI,Pulau Pinang,0,0,0
2021,MWI,Sabah,0,0,0
2021,MWI,Sarawak,0,0,0
2021,MWI,Selangor,31,16,15
2021,MYT,Selangor,0,0,0
2021,NAM,Johor,0,0,0
2021,NAM,Kedah,0,0,0
2021,NAM,Perak,0,0,0
2021,NAM,Perlis,0,0,0
2021,NAM,Pulau Pinang,0,0,0
2021,NAM,Sabah,0,0,0
2021,NAM,Sarawak,0,0,0
2021,NAM,Selangor,19,11,8
2021,NCL,Selangor,0,0,0
2021,NER,Johor,0,0,0
2021,NER,Sabah,0,0,0
2021,NER,Selangor,2,2,0
2021,NGA,Johor,0,0,0
2021,NGA,Kedah,0,0,0
2021,NGA,Perlis,0,0,0
2021,NGA,Pulau Pinang,0,0,0
2021,NGA,Sabah,1,1,0
2021,NGA,Sarawak,8,6,2
2021,NGA,Selangor,1258,1115,143
2021,NIC,Johor,0,0,0
2021,NIC,Kedah,0,0,0
2021,NIC,Pulau Pinang,0,0,0
2021,NIC,Sabah,0,0,0
2021,NIC,Selangor,8,6,2
2021,NLD,Johor,9,9,0
2021,NLD,Kedah,1,0,1
2021,NLD,Kelantan,0,0,0
2021,NLD,Melaka,0,0,0
2021,NLD,Negeri Sembilan,0,0,0
2021,NLD,Pahang,0,0,0
2021,NLD,Perak,0,0,0
2021,NLD,Perlis,0,0,0
2021,NLD,Pulau Pinang,27,16,11
2021,NLD,Sabah,2,2,0
2021,NLD,Sarawak,9,8,1
2021,NLD,Selangor,817,610,207
2021,NLD,Terengganu,0,0,0
2021,NLD,W.P. Labuan,0,0,0
2021,NOR,Johor,2,2,0
2021,NOR,Kedah,0,0,0
2021,NOR,Kelantan,0,0,0
2021,NOR,Melaka,0,0,0
2021,NOR,Pahang,0,0,0
2021,NOR,Perak,0,0,0
2021,NOR,Perlis,0,0,0
2021,NOR,Pulau Pinang,1,1,0
2021,NOR,Sabah,0,0,0
2021,NOR,Sarawak,5,4,1
2021,NOR,Selangor,232,191,41
2021,NOR,W.P. Labuan,0,0,0
2021,NPL,Johor,0,0,0
2021,NPL,Kedah,0,0,0
2021,NPL,Pahang,0,0,0
2021,NPL,Perak,0,0,0
2021,NPL,Perlis,0,0,0
2021,NPL,Pulau Pinang,1,1,0
2021,NPL,Sabah,0,0,0
2021,NPL,Sarawak,0,0,0
2021,NPL,Selangor,1131,1072,59
2021,NPL,W.P. Labuan,0,0,0
2021,NRU,Johor,0,0,0
2021,NRU,Pulau Pinang,0,0,0
2021,NRU,Selangor,0,0,0
2021,NZL,Johor,1,0,1
2021,NZL,Kedah,1,0,1
2021,NZL,Kelantan,0,0,0
2021,NZL,Melaka,0,0,0
2021,NZL,Negeri Sembilan,0,0,0
2021,NZL,Pahang,0,0,0
2021,NZL,Perak,0,0,0
2021,NZL,Perlis,0,0,0
2021,NZL,Pulau Pinang,8,6,2
2021,NZL,Sabah,2,2,0
2021,NZL,Sarawak,1,1,0
2021,NZL,Selangor,292,203,89
2021,NZL,Terengganu,0,0,0
2021,NZL,W.P. Labuan,0,0,0
2021,OMN,Johor,0,0,0
2021,OMN,Kedah,0,0,0
2021,OMN,Kelantan,0,0,0
2021,OMN,Melaka,0,0,0
2021,OMN,Perak,0,0,0
2021,OMN,Perlis,0,0,0
2021,OMN,Pulau Pinang,0,0,0
2021,OMN,Sabah,0,0,0
2021,OMN,Sarawak,0,0,0
2021,OMN,Selangor,187,133,54
2021,PAK,Johor,41,41,0
2021,PAK,Kedah,0,0,0
2021,PAK,Kelantan,0,0,0
2021,PAK,Melaka,0,0,0
2021,PAK,Negeri Sembilan,0,0,0
2021,PAK,Pahang,0,0,0
2021,PAK,Perak,0,0,0
2021,PAK,Perlis,0,0,0
2021,PAK,Pulau Pinang,2,2,0
2021,PAK,Sabah,6,6,0
2021,PAK,Sarawak,4,4,0
2021,PAK,Selangor,5130,4497,633
2021,PAK,W.P. Labuan,0,0,0
2021,PAN,Johor,0,0,0
2021,PAN,Kedah,0,0,0
2021,PAN,Perak,0,0,0
2021,PAN,Perlis,0,0,0
2021,PAN,Pulau Pinang,0,0,0
2021,PAN,Sabah,0,0,0
2021,PAN,Sarawak,0,0,0
2021,PAN,Selangor,21,15,6
2021,PER,Johor,0,0,0
2021,PER,Kedah,0,0,0
2021,PER,Kelantan,0,0,0
2021,PER,Pahang,0,0,0
2021,PER,Perak,0,0,0
2021,PER,Perlis,0,0,0
2021,PER,Pulau Pinang,0,0,0
2021,PER,Sabah,0,0,0
2021,PER,Sarawak,0,0,0
2021,PER,Selangor,22,14,8
2021,PER,W.P. Labuan,0,0,0
2021,PHL,Johor,542,518,24
2021,PHL,Kedah,0,0,0
2021,PHL,Kelantan,0,0,0
2021,PHL,Melaka,0,0,0
2021,PHL,Negeri Sembilan,0,0,0
2021,PHL,Pahang,1,1,0
2021,PHL,Perak,1,0,1
2021,PHL,Perlis,0,0,0
2021,PHL,Pulau Pinang,42,24,18
2021,PHL,Sabah,21,8,13
2021,PHL,Sarawak,538,524,14
2021,PHL,Selangor,6640,5138,1502
2021,PHL,Terengganu,0,0,0
2021,PHL,W.P. Labuan,55,55,0
2021,PLW,Johor,0,0,0
2021,PLW,Pulau Pinang,0,0,0
2021,PLW,Selangor,0,0,0
2021,PNG,Johor,0,0,0
2021,PNG,Kedah,1,0,1
2021,PNG,Kelantan,0,0,0
2021,PNG,Perak,0,0,0
2021,PNG,Pulau Pinang,0,0,0
2021,PNG,Sabah,0,0,0
2021,PNG,Sarawak,1,0,1
2021,PNG,Selangor,10,6,4
2021,POL,Johor,14,14,0
2021,POL,Kedah,1,0,1
2021,POL,Kelantan,0,0,0
2021,POL,Melaka,0,0,0
2021,POL,Negeri Sembilan,0,0,0
2021,POL,Pahang,0,0,0
2021,POL,Perak,0,0,0
2021,POL,Perlis,0,0,0
2021,POL,Pulau Pinang,0,0,0
2021,POL,Sabah,1,1,0
2021,POL,Sarawak,3,3,0
2021,POL,Selangor,339,289,50
2021,POL,Terengganu,0,0,0
2021,POL,W.P. Labuan,0,0,0
2021,PRK,Selangor,1,1,0
2021,PRT,Johor,0,0,0
2021,PRT,Kedah,0,0,0
2021,PRT,Kelantan,0,0,0
2021,PRT,Melaka,0,0,0
2021,PRT,Pahang,0,0,0
2021,PRT,Perak,0,0,0
2021,PRT,Perlis,0,0,0
2021,PRT,Pulau Pinang,3,1,2
2021,PRT,Sabah,0,0,0
2021,PRT,Sarawak,0,0,0
2021,PRT,Selangor,148,83,65
2021,PRT,W.P. Labuan,0,0,0
2021,PRY,Johor,0,0,0
2021,PRY,Kedah,0,0,0
2021,PRY,Perak,0,0,0
2021,PRY,Perlis,0,0,0
2021,PRY,Pulau Pinang,0,0,0
2021,PRY,Sabah,0,0,0
2021,PRY,Sarawak,0,0,0
2021,PRY,Selangor,0,0,0
2021,PSE,Johor,0,0,0
2021,PSE,Kedah,0,0,0
2021,PSE,Kelantan,0,0,0
2021,PSE,Melaka,0,0,0
2021,PSE,Perak,0,0,0
2021,PSE,Perlis,0,0,0
2021,PSE,Pulau Pinang,0,0,0
2021,PSE,Sabah,1,1,0
2021,PSE,Sarawak,0,0,0
2021,PSE,Selangor,250,207,43
2021,QAT,Johor,0,0,0
2021,QAT,Kedah,0,0,0
2021,QAT,Perlis,0,0,0
2021,QAT,Pulau Pinang,0,0,0
2021,QAT,Sabah,0,0,0
2021,QAT,Sarawak,0,0,0
2021,QAT,Selangor,50,32,18
2021,REU,Johor,0,0,0
2021,REU,Sarawak,0,0,0
2021,ROU,Johor,13,13,0
2021,ROU,Kedah,0,0,0
2021,ROU,Kelantan,2,2,0
2021,ROU,Negeri Sembilan,0,0,0
2021,ROU,Pahang,0,0,0
2021,ROU,Perak,0,0,0
2021,ROU,Perlis,0,0,0
2021,ROU,Pulau Pinang,0,0,0
2021,ROU,Sabah,0,0,0
2021,ROU,Sarawak,3,3,0
2021,ROU,Selangor,316,253,63
2021,ROU,W.P. Labuan,0,0,0
2021,RUS,Johor,66,61,5
2021,RUS,Kedah,6,4,2
2021,RUS,Kelantan,2,0,2
2021,RUS,Melaka,0,0,0
2021,RUS,Negeri Sembilan,0,0,0
2021,RUS,Pahang,0,0,0
2021,RUS,Perak,0,0,0
2021,RUS,Perlis,0,0,0
2021,RUS,Pulau Pinang,0,0,0
2021,RUS,Sabah,0,0,0
2021,RUS,Sarawak,8,7,1
2021,RUS,Selangor,873,655,218
2021,RUS,W.P. Labuan,0,0,0
2021,RWA,Johor,0,0,0
2021,RWA,Kedah,0,0,0
2021,RWA,Pulau Pinang,0,0,0
2021,RWA,Selangor,15,7,8
2021,SAU,Johor,0,0,0
2021,SAU,Kedah,0,0,0
2021,SAU,Kelantan,0,0,0
2021,SAU,Melaka,0,0,0
2021,SAU,Perak,0,0,0
2021,SAU,Perlis,0,0,0
2021,SAU,Pulau Pinang,0,0,0
2021,SAU,Sabah,0,0,0
2021,SAU,Sarawak,1,1,0
2021,SAU,Selangor,1146,704,442
2021,SAU,W.P. Labuan,0,0,0
2021,SDN,Johor,0,0,0
2021,SDN,Kedah,0,0,0
2021,SDN,Kelantan,0,0,0
2021,SDN,Perlis,0,0,0
2021,SDN,Pulau Pinang,0,0,0
2021,SDN,Sabah,0,0,0
2021,SDN,Sarawak,0,0,0
2021,SDN,Selangor,692,477,215
2021,SDN,W.P. Labuan,0,0,0
2021,SEN,Johor,0,0,0
2021,SEN,Kedah,0,0,0
2021,SEN,Kelantan,0,0,0
2021,SEN,Perak,0,0,0
2021,SEN,Perlis,0,0,0
2021,SEN,Pulau Pinang,0,0,0
2021,SEN,Sabah,0,0,0
2021,SEN,Sarawak,0,0,0
2021,SEN,Selangor,50,29,21
2021,SGP,Johor,4601,3059,1542
2021,SGP,Kedah,30,21,9
2021,SGP,Kelantan,0,0,0
2021,SGP,Melaka,0,0,0
2021,SGP,Negeri Sembilan,0,0,0
2021,SGP,Pahang,2,2,0
2021,SGP,Perak,35,12,23
2021,SGP,Perlis,10,9,1
2021,SGP,Pulau Pinang,213,123,90
2021,SGP,Sabah,5,3,2
2021,SGP,Sarawak,118,64,54
2021,SGP,Selangor,12678,7264,5414
2021,SGP,Terengganu,0,0,0
2021,SGP,W.P. Labuan,0,0,0
2021,SGS,Johor,1,1,0
2021,SGS,Sabah,0,0,0
2021,SGS,Selangor,0,0,0
2021,SHN,Sarawak,0,0,0
2021,SLB,Johor,0,0,0
2021,SLB,Perlis,0,0,0
2021,SLB,Pulau Pinang,0,0,0
2021,SLB,Sabah,0,0,0
2021,SLB,Sarawak,1,1,0
2021,SLB,Selangor,1,1,0
2021,SLB,W.P. Labuan,0,0,0
2021,SLE,Johor,0,0,0
2021,SLE,Kedah,0,0,0
2021,SLE,Perak,0,0,0
2021,SLE,Pulau Pinang,0,0,0
2021,SLE,Sabah,0,0,0
2021,SLE,Selangor,21,13,8
2021,SLV,Johor,0,0,0
2021,SLV,Kedah,0,0,0
2021,SLV,Perak,0,0,0
2021,SLV,Perlis,0,0,0
2021,SLV,Pulau Pinang,0,0,0
2021,SLV,Sabah,0,0,0
2021,SLV,Selangor,2,1,1
2021,SLV,W.P. Labuan,0,0,0
2021,SMR,Johor,0,0,0
2021,SMR,Selangor,1,1,0
2021,SOM,Johor,0,0,0
2021,SOM,Kedah,0,0,0
2021,SOM,Kelantan,0,0,0
2021,SOM,Perlis,0,0,0
2021,SOM,Sabah,0,0,0
2021,SOM,Sarawak,0,0,0
2021,SOM,Selangor,402,300,102
2021,SRB,Johor,0,0,0
2021,SRB,Kedah,0,0,0
2021,SRB,Kelantan,0,0,0
2021,SRB,Pahang,0,0,0
2021,SRB,Perak,0,0,0
2021,SRB,Perlis,0,0,0
2021,SRB,Pulau Pinang,0,0,0
2021,SRB,Sabah,0,0,0
2021,SRB,Sarawak,0,0,0
2021,SRB,Selangor,34,24,10
2021,SSD,Johor,0,0,0
2021,SSD,Kedah,0,0,0
2021,SSD,Sarawak,0,0,0
2021,SSD,Selangor,38,30,8
2021,SSD,W.P. Labuan,0,0,0
2021,STP,Selangor,2,2,0
2021,SUR,Johor,0,0,0
2021,SUR,Kedah,0,0,0
2021,SUR,Kelantan,0,0,0
2021,SUR,Perak,0,0,0
2021,SUR,Perlis,0,0,0
2021,SUR,Pulau Pinang,0,0,0
2021,SUR,Sabah,0,0,0
2021,SUR,Sarawak,0,0,0
2021,SUR,Selangor,0,0,0
2021,SVK,Johor,0,0,0
2021,SVK,Kedah,0,0,0
2021,SVK,Kelantan,0,0,0
2021,SVK,Negeri Sembilan,0,0,0
2021,SVK,Pahang,0,0,0
2021,SVK,Perak,0,0,0
2021,SVK,Perlis,0,0,0
2021,SVK,Pulau Pinang,0,0,0
2021,SVK,Sabah,0,0,0
2021,SVK,Sarawak,0,0,0
2021,SVK,Selangor,110,86,24
2021,SVK,W.P. Labuan,0,0,0
2021,SVN,Johor,0,0,0
2021,SVN,Kedah,0,0,0
2021,SVN,Kelantan,0,0,0
2021,SVN,Perak,0,0,0
2021,SVN,Perlis,0,0,0
2021,SVN,Pulau Pinang,0,0,0
2021,SVN,Sabah,0,0,0
2021,SVN,Sarawak,1,1,0
2021,SVN,Selangor,19,14,5
2021,SVN,W.P. Labuan,0,0,0
2021,SWE,Johor,2,2,0
2021,SWE,Kedah,0,0,0
2021,SWE,Kelantan,0,0,0
2021,SWE,Melaka,0,0,0
2021,SWE,Negeri Sembilan,0,0,0
2021,SWE,Pahang,0,0,0
2021,SWE,Perak,0,0,0
2021,SWE,Perlis,0,0,0
2021,SWE,Pulau Pinang,6,4,2
2021,SWE,Sabah,1,0,1
2021,SWE,Sarawak,0,0,0
2021,SWE,Selangor,424,347,77
2021,SWE,W.P. Labuan,0,0,0
2021,SWZ,Johor,0,0,0
2021,SWZ,Kedah,0,0,0
2021,SWZ,Pulau Pinang,0,0,0
2021,SWZ,Sabah,0,0,0
2021,SWZ,Selangor,11,5,6
2021,SYC,Johor,1,1,0
2021,SYC,Kedah,0,0,0
2021,SYC,Pulau Pinang,0,0,0
2021,SYC,Sabah,0,0,0
2021,SYC,Sarawak,2,2,0
2021,SYC,Selangor,100,41,59
2021,SYR,Johor,0,0,0
2021,SYR,Kedah,0,0,0
2021,SYR,Kelantan,0,0,0
2021,SYR,Pahang,0,0,0
2021,SYR,Perlis,0,0,0
2021,SYR,Pulau Pinang,0,0,0
2021,SYR,Sabah,0,0,0
2021,SYR,Sarawak,2,2,0
2021,SYR,Selangor,408,279,129
2021,SYR,W.P. Labuan,0,0,0
2021,TCA,Perlis,0,0,0
2021,TCD,Johor,0,0,0
2021,TCD,Kedah,0,0,0
2021,TCD,Perlis,0,0,0
2021,TCD,Selangor,19,17,2
2021,TGO,Johor,0,0,0
2021,TGO,Perak,0,0,0
2021,TGO,Pulau Pinang,0,0,0
2021,TGO,Selangor,6,6,0
2021,THA,Johor,155,153,2
2021,THA,Kedah,214822,214310,512
2021,THA,Kelantan,21,7,14
2021,THA,Melaka,0,0,0
2021,THA,Negeri Sembilan,0,0,0
2021,THA,Pahang,0,0,0
2021,THA,Perak,3,0,3
2021,THA,Perlis,100849,98464,2385
2021,THA,Pulau Pinang,750,710,40
2021,THA,Sabah,1,0,1
2021,THA,Sarawak,124,117,7
2021,THA,Selangor,2626,1331,1295
2021,THA,Terengganu,13,13,0
2021,THA,W.P. Labuan,1,0,1
2021,TJK,Johor,0,0,0
2021,TJK,Kedah,0,0,0
2021,TJK,Perlis,0,0,0
2021,TJK,Pulau Pinang,0,0,0
2021,TJK,Sabah,0,0,0
2021,TJK,Selangor,38,25,13
2021,TKL,Selangor,0,0,0
2021,TKM,Johor,0,0,0
2021,TKM,Kedah,0,0,0
2021,TKM,Kelantan,0,0,0
2021,TKM,Perlis,0,0,0
2021,TKM,Pulau Pinang,0,0,0
2021,TKM,Sabah,0,0,0
2021,TKM,Sarawak,0,0,0
2021,TKM,Selangor,29,15,14
2021,TLS,Johor,0,0,0
2021,TLS,Kedah,0,0,0
2021,TLS,Perlis,0,0,0
2021,TLS,Pulau Pinang,0,0,0
2021,TLS,Sabah,0,0,0
2021,TLS,Sarawak,0,0,0
2021,TLS,Selangor,25,12,13
2021,TON,Johor,0,0,0
2021,TON,Pulau Pinang,0,0,0
2021,TON,Sarawak,0,0,0
2021,TON,Selangor,0,0,0
2021,TTO,Johor,0,0,0
2021,TTO,Kedah,0,0,0
2021,TTO,Pahang,0,0,0
2021,TTO,Pulau Pinang,0,0,0
2021,TTO,Sabah,0,0,0
2021,TTO,Sarawak,0,0,0
2021,TTO,Selangor,14,7,7
2021,TUN,Johor,0,0,0
2021,TUN,Kedah,0,0,0
2021,TUN,Kelantan,0,0,0
2021,TUN,Melaka,0,0,0
2021,TUN,Perak,0,0,0
2021,TUN,Perlis,0,0,0
2021,TUN,Pulau Pinang,0,0,0
2021,TUN,Sabah,0,0,0
2021,TUN,Sarawak,0,0,0
2021,TUN,Selangor,78,39,39
2021,TUN,W.P. Labuan,0,0,0
2021,TUR,Johor,4,4,0
2021,TUR,Kedah,0,0,0
2021,TUR,Kelantan,0,0,0
2021,TUR,Melaka,0,0,0
2021,TUR,Negeri Sembilan,0,0,0
2021,TUR,Pahang,0,0,0
2021,TUR,Perak,1,1,0
2021,TUR,Perlis,0,0,0
2021,TUR,Pulau Pinang,0,0,0
2021,TUR,Sabah,0,0,0
2021,TUR,Sarawak,3,3,0
2021,TUR,Selangor,541,409,132
2021,TUR,W.P. Labuan,0,0,0
2021,TUV,Selangor,0,0,0
2021,TWN,Johor,10,5,5
2021,TWN,Kedah,3,1,2
2021,TWN,Kelantan,0,0,0
2021,TWN,Melaka,0,0,0
2021,TWN,Negeri Sembilan,0,0,0
2021,TWN,Pahang,0,0,0
2021,TWN,Perak,0,0,0
2021,TWN,Perlis,0,0,0
2021,TWN,Pulau Pinang,168,116,52
2021,TWN,Sabah,1,0,1
2021,TWN,Sarawak,11,7,4
2021,TWN,Selangor,968,624,344
2021,TWN,W.P. Labuan,0,0,0
2021,TZA,Johor,0,0,0
2021,TZA,Kedah,0,0,0
2021,TZA,Perak,0,0,0
2021,TZA,Perlis,0,0,0
2021,TZA,Pulau Pinang,0,0,0
2021,TZA,Sabah,0,0,0
2021,TZA,Sarawak,0,0,0
2021,TZA,Selangor,214,116,98
2021,UGA,Johor,0,0,0
2021,UGA,Kedah,0,0,0
2021,UGA,Perak,0,0,0
2021,UGA,Perlis,0,0,0
2021,UGA,Pulau Pinang,0,0,0
2021,UGA,Sabah,0,0,0
2021,UGA,Sarawak,0,0,0
2021,UGA,Selangor,60,31,29
2021,UKR,Johor,94,93,1
2021,UKR,Kedah,0,0,0
2021,UKR,Kelantan,0,0,0
2021,UKR,Melaka,3,3,0
2021,UKR,Negeri Sembilan,0,0,0
2021,UKR,Pahang,0,0,0
2021,UKR,Perak,0,0,0
2021,UKR,Perlis,0,0,0
2021,UKR,Pulau Pinang,8,8,0
2021,UKR,Sabah,0,0,0
2021,UKR,Sarawak,1,1,0
2021,UKR,Selangor,694,638,56
2021,UKR,W.P. Labuan,0,0,0
2021,URY,Johor,0,0,0
2021,URY,Kedah,0,0,0
2021,URY,Kelantan,0,0,0
2021,URY,Perak,0,0,0
2021,URY,Perlis,0,0,0
2021,URY,Pulau Pinang,0,0,0
2021,URY,Sabah,0,0,0
2021,URY,Sarawak,0,0,0
2021,URY,Selangor,9,3,6
2021,URY,W.P. Labuan,0,0,0
2021,USA,Johor,12,9,3
2021,USA,Kedah,7,7,0
2021,USA,Kelantan,0,0,0
2021,USA,Melaka,0,0,0
2021,USA,Negeri Sembilan,0,0,0
2021,USA,Pahang,0,0,0
2021,USA,Perak,6,3,3
2021,USA,Perlis,0,0,0
2021,USA,Pulau Pinang,148,97,51
2021,USA,Sabah,4,3,1
2021,USA,Sarawak,15,10,5
2021,USA,Selangor,3073,1980,1093
2021,USA,Terengganu,0,0,0
2021,USA,W.P. Labuan,0,0,0
2021,UZB,Johor,0,0,0
2021,UZB,Kedah,0,0,0
2021,UZB,Kelantan,0,0,0
2021,UZB,Perak,0,0,0
2021,UZB,Perlis,0,0,0
2021,UZB,Pulau Pinang,0,0,0
2021,UZB,Sabah,0,0,0
2021,UZB,Sarawak,0,0,0
2021,UZB,Selangor,197,135,62
2021,VAT,Johor,0,0,0
2021,VAT,Sarawak,0,0,0
2021,VAT,Selangor,5,5,0
2021,VCT,Johor,0,0,0
2021,VCT,Kedah,0,0,0
2021,VCT,Pulau Pinang,0,0,0
2021,VCT,Sarawak,0,0,0
2021,VCT,Selangor,0,0,0
2021,VEN,Johor,0,0,0
2021,VEN,Kedah,0,0,0
2021,VEN,Kelantan,0,0,0
2021,VEN,Melaka,0,0,0
2021,VEN,Perak,0,0,0
2021,VEN,Perlis,0,0,0
2021,VEN,Pulau Pinang,0,0,0
2021,VEN,Sabah,0,0,0
2021,VEN,Sarawak,0,0,0
2021,VEN,Selangor,37,32,5
2021,VEN,W.P. Labuan,0,0,0
2021,VNM,Johor,17,4,13
2021,VNM,Kedah,9,2,7
2021,VNM,Kelantan,0,0,0
2021,VNM,Melaka,0,0,0
2021,VNM,Negeri Sembilan,0,0,0
2021,VNM,Pahang,0,0,0
2021,VNM,Perak,1,0,1
2021,VNM,Perlis,0,0,0
2021,VNM,Pulau Pinang,14,3,11
2021,VNM,Sabah,1,0,1
2021,VNM,Sarawak,4,0,4
2021,VNM,Selangor,1230,407,823
2021,VNM,Terengganu,29,29,0
2021,VNM,W.P. Labuan,0,0,0
2021,VUT,Johor,0,0,0
2021,VUT,Kedah,0,0,0
2021,VUT,Pulau Pinang,0,0,0
2021,VUT,Sabah,0,0,0
2021,VUT,Sarawak,0,0,0
2021,VUT,Selangor,9,7,2
2021,WSM,Johor,0,0,0
2021,WSM,Sarawak,0,0,0
2021,WSM,Selangor,0,0,0
2021,XXX,Johor,2,2,0
2021,XXX,Kedah,0,0,0
2021,XXX,Kelantan,0,0,0
2021,XXX,Melaka,0,0,0
2021,XXX,Pahang,0,0,0
2021,XXX,Perak,1,0,1
2021,XXX,Perlis,0,0,0
2021,XXX,Pulau Pinang,6,2,4
2021,XXX,Sabah,0,0,0
2021,XXX,Sarawak,1,0,1
2021,XXX,Selangor,165,108,57
2021,XXX,W.P. Labuan,0,0,0
2021,YEM,Johor,0,0,0
2021,YEM,Kedah,2,2,0
2021,YEM,Kelantan,0,0,0
2021,YEM,Melaka,0,0,0
2021,YEM,Pahang,0,0,0
2021,YEM,Perak,0,0,0
2021,YEM,Perlis,0,0,0
2021,YEM,Pulau Pinang,0,0,0
2021,YEM,Sabah,0,0,0
2021,YEM,Sarawak,0,0,0
2021,YEM,Selangor,1199,918,281
2021,YEM,W.P. Labuan,0,0,0
2021,ZAF,Johor,13,13,0
2021,ZAF,Kedah,1,1,0
2021,ZAF,Kelantan,0,0,0
2021,ZAF,Melaka,0,0,0
2021,ZAF,Pahang,0,0,0
2021,ZAF,Perak,0,0,0
2021,ZAF,Perlis,0,0,0
2021,ZAF,Pulau Pinang,3,1,2
2021,ZAF,Sabah,1,1,0
2021,ZAF,Sarawak,1,0,1
2021,ZAF,Selangor,470,348,122
2021,ZAF,Terengganu,0,0,0
2021,ZAF,W.P. Labuan,0,0,0
2021,ZAR,Selangor,0,0,0
2021,ZMB,Johor,0,0,0
2021,ZMB,Kedah,0,0,0
2021,ZMB,Perak,0,0,0
2021,ZMB,Perlis,0,0,0
2021,ZMB,Pulau Pinang,0,0,0
2021,ZMB,Sabah,0,0,0
2021,ZMB,Sarawak,0,0,0
2021,ZMB,Selangor,108,51,57
2021,ZWE,Johor,0,0,0
2021,ZWE,Kedah,0,0,0
2021,ZWE,Kelantan,0,0,0
2021,ZWE,Perak,0,0,0
2021,ZWE,Perlis,0,0,0
2021,ZWE,Pulau Pinang,1,1,0
2021,ZWE,Sabah,0,0,0
2021,ZWE,Sarawak,0,0,0
2021,ZWE,Selangor,97,43,54
2022,ABW,Kedah,1,0,1
2022,ABW,Pulau Pinang,1,0,1
2022,AFG,Johor,5,5,0
2022,AFG,Kedah,0,0,0
2022,AFG,Perlis,0,0,0
2022,AFG,Pulau Pinang,0,0,0
2022,AFG,Sarawak,3,2,1
2022,AFG,Selangor,857,627,230
2022,AGO,Johor,2,2,0
2022,AGO,Kedah,1,0,1
2022,AGO,Sabah,1,1,0
2022,AGO,Selangor,31,21,10
2022,AIA,Selangor,1,1,0
2022,ALB,Johor,100,71,29
2022,ALB,Kedah,3,3,0
2022,ALB,Perak,0,0,0
2022,ALB,Perlis,1,1,0
2022,ALB,Pulau Pinang,10,7,3
2022,ALB,Sabah,1,0,1
2022,ALB,Sarawak,0,0,0
2022,ALB,Selangor,235,142,93
2022,AND,Johor,3,1,2
2022,AND,Kedah,2,1,1
2022,AND,Perlis,2,0,2
2022,AND,Pulau Pinang,1,0,1
2022,AND,Selangor,28,15,13
2022,ANT,Selangor,0,0,0
2022,ARE,Johor,254,156,98
2022,ARE,Kedah,27,14,13
2022,ARE,Kelantan,1,1,0
2022,ARE,Perak,1,0,1
2022,ARE,Perlis,3,3,0
2022,ARE,Pulau Pinang,10,6,4
2022,ARE,Sabah,1,1,0
2022,ARE,Sarawak,2,2,0
2022,ARE,Selangor,3325,1975,1350
2022,ARG,Johor,379,230,149
2022,ARG,Kedah,117,69,48
2022,ARG,Kelantan,10,6,4
2022,ARG,Melaka,0,0,0
2022,ARG,Perak,6,4,2
2022,ARG,Perlis,27,16,11
2022,ARG,Pulau Pinang,45,25,20
2022,ARG,Sabah,20,7,13
2022,ARG,Sarawak,15,6,9
2022,ARG,Selangor,1813,1049,764
2022,ARG,W.P. Labuan,0,0,0
2022,ARM,Johor,45,23,22
2022,ARM,Kedah,9,5,4
2022,ARM,Kelantan,0,0,0
2022,ARM,Perak,0,0,0
2022,ARM,Perlis,0,0,0
2022,ARM,Pulau Pinang,4,4,0
2022,ARM,Sabah,3,1,2
2022,ARM,Sarawak,0,0,0
2022,ARM,Selangor,197,89,108
2022,ATA,Selangor,2,1,1
2022,ATG,Johor,34,20,14
2022,ATG,Kedah,5,2,3
2022,ATG,Pulau Pinang,2,1,1
2022,ATG,Sarawak,1,1,0
2022,ATG,Selangor,98,65,33
2022,AUS,Johor,31341,18773,12568
2022,AUS,Kedah,3165,1774,1391
2022,AUS,Kelantan,27,22,5
2022,AUS,Melaka,25,18,7
2022,AUS,Negeri Sembilan,4,3,1
2022,AUS,Pahang,37,21,16
2022,AUS,Perak,1290,670,620
2022,AUS,Perlis,316,217,99
2022,AUS,Pulau Pinang,10817,5927,4890
2022,AUS,Sabah,2689,1432,1257
2022,AUS,Sarawak,3441,1874,1567
2022,AUS,Selangor,126157,74345,51812
2022,AUS,Terengganu,1,1,0
2022,AUS,W.P. Labuan,65,41,24
2022,AUT,Johor,1061,713,348
2022,AUT,Kedah,215,121,94
2022,AUT,Kelantan,4,4,0
2022,AUT,Melaka,3,2,1
2022,AUT,Negeri Sembilan,1,1,0
2022,AUT,Pahang,1,1,0
2022,AUT,Perak,26,15,11
2022,AUT,Perlis,74,42,32
2022,AUT,Pulau Pinang,491,369,122
2022,AUT,Sabah,102,64,38
2022,AUT,Sarawak,88,61,27
2022,AUT,Selangor,4956,3225,1731
2022,AUT,Terengganu,2,1,1
2022,AUT,W.P. Labuan,2,1,1
2022,AZE,Johor,34,25,9
2022,AZE,Kedah,16,11,5
2022,AZE,Kelantan,0,0,0
2022,AZE,Melaka,0,0,0
2022,AZE,Perlis,0,0,0
2022,AZE,Pulau Pinang,1,0,1
2022,AZE,Sabah,4,2,2
2022,AZE,Sarawak,2,1,1
2022,AZE,Selangor,588,333,255
2022,AZE,W.P. Labuan,0,0,0
2022,BDI,Pulau Pinang,0,0,0
2022,BDI,Sarawak,0,0,0
2022,BDI,Selangor,31,19,12
2022,BEL,Johor,1605,1070,535
2022,BEL,Kedah,222,128,94
2022,BEL,Kelantan,11,8,3
2022,BEL,Melaka,0,0,0
2022,BEL,Negeri Sembilan,1,1,0
2022,BEL,Pahang,6,4,2
2022,BEL,Perak,29,18,11
2022,BEL,Perlis,50,36,14
2022,BEL,Pulau Pinang,359,240,119
2022,BEL,Sabah,153,89,64
2022,BEL,Sarawak,133,75,58
2022,BEL,Selangor,6574,4113,2461
2022,BEL,W.P. Labuan,3,2,1
2022,BEN,Johor,4,2,2
2022,BEN,Kedah,1,1,0
2022,BEN,Perak,2,1,1
2022,BEN,Pulau Pinang,1,1,0
2022,BEN,Sabah,1,1,0
2022,BEN,Sarawak,0,0,0
2022,BEN,Selangor,55,41,14
2022,BFA,Perak,1,0,1
2022,BFA,Pulau Pinang,2,2,0
2022,BFA,Selangor,39,32,7
2022,BGD,Johor,12834,10525,2309
2022,BGD,Kedah,265,177,88
2022,BGD,Kelantan,4,4,0
2022,BGD,Melaka,0,0,0
2022,BGD,Negeri Sembilan,1,1,0
2022,BGD,Pahang,0,0,0
2022,BGD,Perak,3,3,0
2022,BGD,Perlis,33,29,4
2022,BGD,Pulau Pinang,1474,1402,72
2022,BGD,Sabah,14,10,4
2022,BGD,Sarawak,216,185,31
2022,BGD,Selangor,224290,210352,13938
2022,BGD,W.P. Labuan,10,10,0
2022,BGR,Johor,332,189,143
2022,BGR,Kedah,41,16,25
2022,BGR,Kelantan,1,0,1
2022,BGR,Pahang,2,2,0
2022,BGR,Perak,3,1,2
2022,BGR,Perlis,4,1,3
2022,BGR,Pulau Pinang,43,20,23
2022,BGR,Sabah,9,4,5
2022,BGR,Sarawak,14,5,9
2022,BGR,Selangor,1110,688,422
2022,BGR,W.P. Labuan,0,0,0
2022,BHR,Johor,104,55,49
2022,BHR,Kedah,7,4,3
2022,BHR,Kelantan,1,1,0
2022,BHR,Perlis,5,5,0
2022,BHR,Pulau Pinang,15,10,5
2022,BHR,Sabah,2,2,0
2022,BHR,Sarawak,5,5,0
2022,BHR,Selangor,1210,681,529
2022,BHS,Johor,11,6,5
2022,BHS,Kedah,2,1,1
2022,BHS,Perak,1,0,1
2022,BHS,Sabah,0,0,0
2022,BHS,Sarawak,1,0,1
2022,BHS,Selangor,35,13,22
2022,BIH,Johor,51,32,19
2022,BIH,Kedah,2,2,0
2022,BIH,Perlis,0,0,0
2022,BIH,Pulau Pinang,6,4,2
2022,BIH,Sabah,2,1,1
2022,BIH,Sarawak,8,8,0
2022,BIH,Selangor,338,204,134
2022,BLR,Johor,82,45,37
2022,BLR,Kedah,40,14,26
2022,BLR,Kelantan,4,1,3
2022,BLR,Pahang,1,0,1
2022,BLR,Perak,4,1,3
2022,BLR,Perlis,2,1,1
2022,BLR,Pulau Pinang,32,18,14
2022,BLR,Sabah,8,5,3
2022,BLR,Sarawak,19,9,10
2022,BLR,Selangor,1168,550,618
2022,BLR,W.P. Labuan,0,0,0
2022,BLZ,Johor,12,4,8
2022,BLZ,Pulau Pinang,0,0,0
2022,BLZ,Sarawak,4,3,1
2022,BLZ,Selangor,35,17,18
2022,BMU,Selangor,0,0,0
2022,BOL,Johor,13,6,7
2022,BOL,Kedah,0,0,0
2022,BOL,Melaka,0,0,0
2022,BOL,Perak,1,1,0
2022,BOL,Perlis,0,0,0
2022,BOL,Pulau Pinang,10,5,5
2022,BOL,Sabah,0,0,0
2022,BOL,Sarawak,19,10,9
2022,BOL,Selangor,133,81,52
2022,BRA,Johor,1476,832,644
2022,BRA,Kedah,195,92,103
2022,BRA,Kelantan,2,1,1
2022,BRA,Melaka,6,4,2
2022,BRA,Pahang,0,0,0
2022,BRA,Perak,19,14,5
2022,BRA,Perlis,47,24,23
2022,BRA,Pulau Pinang,109,72,37
2022,BRA,Sabah,45,23,22
2022,BRA,Sarawak,37,21,16
2022,BRA,Selangor,5037,2939,2098
2022,BRA,W.P. Labuan,1,0,1
2022,BRB,Johor,3,0,3
2022,BRB,Kedah,0,0,0
2022,BRB,Perlis,1,0,1
2022,BRB,Pulau Pinang,1,1,0
2022,BRB,Selangor,46,24,22
2022,BRN,Johor,2671,1395,1276
2022,BRN,Kedah,90,48,42
2022,BRN,Kelantan,18,17,1
2022,BRN,Melaka,0,0,0
2022,BRN,Pahang,0,0,0
2022,BRN,Perak,18,7,11
2022,BRN,Perlis,114,61,53
2022,BRN,Pulau Pinang,86,38,48
2022,BRN,Sabah,6044,2860,3184
2022,BRN,Sarawak,354610,190943,163667
2022,BRN,Selangor,30124,15331,14793
2022,BRN,W.P. Labuan,4516,2880,1636
2022,BTN,Johor,9,8,1
2022,BTN,Kedah,3,2,1
2022,BTN,Perak,0,0,0
2022,BTN,Perlis,0,0,0
2022,BTN,Pulau Pinang,25,12,13
2022,BTN,Sabah,1,1,0
2022,BTN,Sarawak,0,0,0
2022,BTN,Selangor,296,176,120
2022,BWA,Johor,11,4,7
2022,BWA,Kedah,5,4,1
2022,BWA,Perlis,0,0,0
2022,BWA,Pulau Pinang,3,2,1
2022,BWA,Sabah,1,1,0
2022,BWA,Sarawak,1,1,0
2022,BWA,Selangor,103,53,50
2022,CAF,Kedah,0,0,0
2022,CAF,Selangor,1,1,0
2022,CAN,Johor,7902,4738,3164
2022,CAN,Kedah,692,393,299
2022,CAN,Kelantan,22,9,13
2022,CAN,Melaka,3,3,0
2022,CAN,Negeri Sembilan,0,0,0
2022,CAN,Pahang,8,3,5
2022,CAN,Perak,165,100,65
2022,CAN,Perlis,185,126,59
2022,CAN,Pulau Pinang,2049,1189,860
2022,CAN,Sabah,691,367,324
2022,CAN,Sarawak,1331,717,614
2022,CAN,Selangor,23347,14016,9331
2022,CAN,Terengganu,0,0,0
2022,CAN,W.P. Labuan,15,12,3
2022,CCK,Selangor,2,2,0
2022,CHE,Johor,2616,1637,979
2022,CHE,Kedah,506,292,214
2022,CHE,Kelantan,17,12,5
2022,CHE,Melaka,6,3,3
2022,CHE,Negeri Sembilan,2,1,1
2022,CHE,Pahang,3,2,1
2022,CHE,Perak,37,28,9
2022,CHE,Perlis,109,69,40
2022,CHE,Pulau Pinang,714,476,238
2022,CHE,Sabah,242,131,111
2022,CHE,Sarawak,215,109,106
2022,CHE,Selangor,7729,4811,2918
2022,CHE,W.P. Labuan,6,5,1
2022,CHL,Johor,204,113,91
2022,CHL,Kedah,44,17,27
2022,CHL,Kelantan,1,1,0
2022,CHL,Melaka,2,1,1
2022,CHL,Pahang,0,0,0
2022,CHL,Perak,2,0,2
2022,CHL,Perlis,31,22,9
2022,CHL,Pulau Pinang,23,14,9
2022,CHL,Sabah,13,7,6
2022,CHL,Sarawak,3,1,2
2022,CHL,Selangor,928,529,399
2022,CHN,Johor,151948,62192,89756
2022,CHN,Kedah,2841,1181,1660
2022,CHN,Kelantan,38,17,21
2022,CHN,Melaka,11,7,4
2022,CHN,Pahang,36,18,18
2022,CHN,Perak,1022,440,582
2022,CHN,Perlis,287,156,131
2022,CHN,Pulau Pinang,9884,4893,4991
2022,CHN,Sabah,2690,1165,1525
2022,CHN,Sarawak,2453,1202,1251
2022,CHN,Selangor,123044,73234,49810
2022,CHN,Terengganu,0,0,0
2022,CHN,W.P. Labuan,57,38,19
2022,CIV,Johor,6,3,3
2022,CIV,Kedah,2,0,2
2022,CIV,Pulau Pinang,1,1,0
2022,CIV,Sabah,1,0,1
2022,CIV,Sarawak,1,0,1
2022,CIV,Selangor,171,124,47
2022,CMR,Johor,18,18,0
2022,CMR,Kedah,0,0,0
2022,CMR,Pulau Pinang,6,5,1
2022,CMR,Sabah,1,1,0
2022,CMR,Sarawak,2,1,1
2022,CMR,Selangor,164,109,55
2022,COD,Johor,1,1,0
2022,COD,Pulau Pinang,0,0,0
2022,COD,Sarawak,0,0,0
2022,COD,Selangor,68,49,19
2022,COG,Johor,0,0,0
2022,COG,Kedah,0,0,0
2022,COG,Selangor,16,13,3
2022,COK,Selangor,0,0,0
2022,COL,Johor,186,82,104
2022,COL,Kedah,16,5,11
2022,COL,Perak,5,2,3
2022,COL,Pulau Pinang,17,5,12
2022,COL,Sabah,8,5,3
2022,COL,Sarawak,5,3,2
2022,COL,Selangor,1010,539,471
2022,COL,W.P. Labuan,0,0,0
2022,COM,Johor,1,0,1
2022,COM,Kedah,1,0,1
2022,COM,Selangor,104,64,40
2022,CPV,Johor,1,1,0
2022,CPV,Kedah,0,0,0
2022,CPV,Pulau Pinang,1,0,1
2022,CPV,Sabah,0,0,0
2022,CPV,Selangor,21,11,10
2022,CRI,Johor,59,39,20
2022,CRI,Kedah,3,1,2
2022,CRI,Perak,2,1,1
2022,CRI,Perlis,4,4,0
2022,CRI,Pulau Pinang,39,19,20
2022,CRI,Sabah,2,1,1
2022,CRI,Sarawak,3,1,2
2022,CRI,Selangor,337,176,161
2022,CUB,Johor,38,30,8
2022,CUB,Kedah,3,2,1
2022,CUB,Perlis,1,1,0
2022,CUB,Pulau Pinang,2,1,1
2022,CUB,Sabah,0,0,0
2022,CUB,Sarawak,2,1,1
2022,CUB,Selangor,166,91,75
2022,CYP,Johor,76,55,21
2022,CYP,Kedah,16,11,5
2022,CYP,Perak,2,2,0
2022,CYP,Perlis,0,0,0
2022,CYP,Pulau Pinang,19,15,4
2022,CYP,Sabah,6,3,3
2022,CYP,Sarawak,8,3,5
2022,CYP,Selangor,360,234,126
2022,CZE,Johor,632,384,248
2022,CZE,Kedah,246,117,129
2022,CZE,Kelantan,19,13,6
2022,CZE,Melaka,0,0,0
2022,CZE,Negeri Sembilan,1,1,0
2022,CZE,Perak,3,1,2
2022,CZE,Perlis,66,40,26
2022,CZE,Pulau Pinang,124,75,49
2022,CZE,Sabah,53,29,24
2022,CZE,Sarawak,55,29,26
2022,CZE,Selangor,2701,1640,1061
2022,CZE,W.P. Labuan,2,0,2
2022,DEU,Johor,13212,8677,4535
2022,DEU,Kedah,2275,1229,1046
2022,DEU,Kelantan,60,41,19
2022,DEU,Melaka,16,9,7
2022,DEU,Negeri Sembilan,3,2,1
2022,DEU,Pahang,9,7,2
2022,DEU,Perak,148,104,44
2022,DEU,Perlis,534,325,209
2022,DEU,Pulau Pinang,3767,2753,1014
2022,DEU,Sabah,825,491,334
2022,DEU,Sarawak,1112,682,430
2022,DEU,Selangor,46291,28929,17362
2022,DEU,Terengganu,1,1,0
2022,DEU,W.P. Labuan,23,15,8
2022,DJI,Johor,1,1,0
2022,DJI,Selangor,121,76,45
2022,DMA,Johor,38,34,4
2022,DMA,Kedah,1,1,0
2022,DMA,Pulau Pinang,8,7,1
2022,DMA,Sabah,0,0,0
2022,DMA,Sarawak,6,3,3
2022,DMA,Selangor,195,154,41
2022,DMA,W.P. Labuan,0,0,0
2022,DNK,Johor,1855,1245,610
2022,DNK,Kedah,353,181,172
2022,DNK,Kelantan,3,1,2
2022,DNK,Melaka,0,0,0
2022,DNK,Negeri Sembilan,0,0,0
2022,DNK,Pahang,30,13,17
2022,DNK,Perak,17,14,3
2022,DNK,Perlis,57,39,18
2022,DNK,Pulau Pinang,382,260,122
2022,DNK,Sabah,190,118,72
2022,DNK,Sarawak,138,80,58
2022,DNK,Selangor,6263,3929,2334
2022,DNK,W.P. Labuan,2,1,1
2022,DOM,Johor,12,5,7
2022,DOM,Kedah,0,0,0
2022,DOM,Perak,1,0,1
2022,DOM,Perlis,1,0,1
2022,DOM,Pulau Pinang,2,1,1
2022,DOM,Sabah,0,0,0
2022,DOM,Sarawak,1,0,1
2022,DOM,Selangor,110,59,51
2022,DZA,Johor,226,185,41
2022,DZA,Kedah,19,17,2
2022,DZA,Kelantan,3,3,0
2022,DZA,Melaka,1,1,0
2022,DZA,Perak,0,0,0
2022,DZA,Perlis,5,4,1
2022,DZA,Pulau Pinang,8,7,1
2022,DZA,Sabah,17,14,3
2022,DZA,Sarawak,9,8,1
2022,DZA,Selangor,3412,2097,1315
2022,DZA,W.P. Labuan,0,0,0
2022,ECU,Johor,65,35,30
2022,ECU,Kedah,10,3,7
2022,ECU,Perak,2,1,1
2022,ECU,Perlis,0,0,0
2022,ECU,Pulau Pinang,10,3,7
2022,ECU,Sabah,3,1,2
2022,ECU,Sarawak,10,4,6
2022,ECU,Selangor,357,183,174
2022,EGY,Johor,1374,1087,287
2022,EGY,Kedah,29,21,8
2022,EGY,Kelantan,5,5,0
2022,EGY,Melaka,1,0,1
2022,EGY,Pahang,0,0,0
2022,EGY,Perak,1,1,0
2022,EGY,Perlis,4,4,0
2022,EGY,Pulau Pinang,52,39,13
2022,EGY,Sabah,39,29,10
2022,EGY,Sarawak,618,415,203
2022,EGY,Selangor,12208,8065,4143
2022,EGY,Terengganu,0,0,0
2022,EGY,W.P. Labuan,1,1,0
2022,ERI,Johor,3,1,2
2022,ERI,Pulau Pinang,0,0,0
2022,ERI,Sabah,0,0,0
2022,ERI,Selangor,111,62,49
2022,ESP,Johor,3532,1997,1535
2022,ESP,Kedah,665,361,304
2022,ESP,Kelantan,31,15,16
2022,ESP,Melaka,3,1,2
2022,ESP,Negeri Sembilan,1,1,0
2022,ESP,Pahang,1,1,0
2022,ESP,Perak,35,21,14
2022,ESP,Perlis,97,61,36
2022,ESP,Pulau Pinang,728,390,338
2022,ESP,Sabah,274,150,124
2022,ESP,Sarawak,331,183,148
2022,ESP,Selangor,19518,11209,8309
2022,ESP,W.P. Labuan,5,3,2
2022,EST,Johor,132,76,56
2022,EST,Kedah,77,41,36
2022,EST,Kelantan,0,0,0
2022,EST,Pahang,0,0,0
2022,EST,Perak,3,2,1
2022,EST,Perlis,10,7,3
2022,EST,Pulau Pinang,28,8,20
2022,EST,Sabah,18,10,8
2022,EST,Sarawak,11,8,3
2022,EST,Selangor,733,375,358
2022,EST,W.P. Labuan,0,0,0
2022,ETH,Johor,16,11,5
2022,ETH,Kedah,0,0,0
2022,ETH,Pulau Pinang,3,3,0
2022,ETH,Sarawak,4,2,2
2022,ETH,Selangor,275,185,90
2022,FIN,Johor,1222,746,476
2022,FIN,Kedah,239,119,120
2022,FIN,Kelantan,0,0,0
2022,FIN,Melaka,0,0,0
2022,FIN,Negeri Sembilan,0,0,0
2022,FIN,Pahang,4,2,2
2022,FIN,Perak,13,8,5
2022,FIN,Perlis,15,10,5
2022,FIN,Pulau Pinang,208,123,85
2022,FIN,Sabah,60,32,28
2022,FIN,Sarawak,52,25,27
2022,FIN,Selangor,2976,1811,1165
2022,FIN,W.P. Labuan,2,2,0
2022,FJI,Johor,294,148,146
2022,FJI,Kedah,6,4,2
2022,FJI,Kelantan,0,0,0
2022,FJI,Perak,5,4,1
2022,FJI,Perlis,2,1,1
2022,FJI,Pulau Pinang,15,7,8
2022,FJI,Sabah,6,4,2
2022,FJI,Sarawak,14,8,6
2022,FJI,Selangor,586,336,250
2022,FRA,Johor,13919,8671,5248
2022,FRA,Kedah,1895,1089,806
2022,FRA,Kelantan,46,31,15
2022,FRA,Melaka,14,7,7
2022,FRA,Negeri Sembilan,14,6,8
2022,FRA,Pahang,28,18,10
2022,FRA,Perak,170,109,61
2022,FRA,Perlis,378,239,139
2022,FRA,Pulau Pinang,2153,1400,753
2022,FRA,Sabah,837,496,341
2022,FRA,Sarawak,703,427,276
2022,FRA,Selangor,49866,29972,19894
2022,FRA,Terengganu,5,3,2
2022,FRA,W.P. Labuan,28,22,6
2022,FSM,Johor,0,0,0
2022,FSM,Pulau Pinang,0,0,0
2022,FSM,Selangor,2,1,1
2022,GAB,Johor,20,10,10
2022,GAB,Pulau Pinang,0,0,0
2022,GAB,Sarawak,0,0,0
2022,GAB,Selangor,48,23,25
2022,GBR,Johor,30512,19848,10664
2022,GBR,Kedah,4909,2787,2122
2022,GBR,Kelantan,50,35,15
2022,GBR,Melaka,13,8,5
2022,GBR,Negeri Sembilan,5,3,2
2022,GBR,Pahang,58,48,10
2022,GBR,Perak,545,313,232
2022,GBR,Perlis,772,484,288
2022,GBR,Pulau Pinang,7970,4805,3165
2022,GBR,Sabah,3157,1758,1399
2022,GBR,Sarawak,6358,3908,2450
2022,GBR,Selangor,109446,67352,42094
2022,GBR,Terengganu,8,8,0
2022,GBR,W.P. Labuan,195,140,55
2022,GEO,Johor,68,54,14
2022,GEO,Kedah,6,4,2
2022,GEO,Melaka,0,0,0
2022,GEO,Perak,1,0,1
2022,GEO,Perlis,5,4,1
2022,GEO,Pulau Pinang,2,1,1
2022,GEO,Sabah,0,0,0
2022,GEO,Sarawak,1,0,1
2022,GEO,Selangor,302,209,93
2022,GHA,Johor,61,26,35
2022,GHA,Kedah,0,0,0
2022,GHA,Kelantan,0,0,0
2022,GHA,Pulau Pinang,4,2,2
2022,GHA,Sabah,1,0,1
2022,GHA,Sarawak,3,2,1
2022,GHA,Selangor,438,306,132
2022,GIB,Johor,0,0,0
2022,GIB,Sarawak,1,0,1
2022,GIN,Johor,20,14,6
2022,GIN,Kedah,0,0,0
2022,GIN,Kelantan,2,2,0
2022,GIN,Perlis,7,4,3
2022,GIN,Pulau Pinang,1,1,0
2022,GIN,Sabah,0,0,0
2022,GIN,Sarawak,0,0,0
2022,GIN,Selangor,335,246,89
2022,GLP,Selangor,0,0,0
2022,GMB,Johor,18,13,5
2022,GMB,Kedah,0,0,0
2022,GMB,Kelantan,0,0,0
2022,GMB,Pulau Pinang,1,1,0
2022,GMB,Sabah,0,0,0
2022,GMB,Sarawak,0,0,0
2022,GMB,Selangor,145,93,52
2022,GNB,Johor,0,0,0
2022,GNB,Selangor,3,2,1
2022,GNQ,Johor,0,0,0
2022,GNQ,Selangor,8,7,1
2022,GRC,Johor,303,236,67
2022,GRC,Kedah,57,33,24
2022,GRC,Kelantan,1,0,1
2022,GRC,Melaka,0,0,0
2022,GRC,Negeri Sembilan,1,1,0
2022,GRC,Pahang,3,3,0
2022,GRC,Perak,3,2,1
2022,GRC,Perlis,8,4,4
2022,GRC,Pulau Pinang,39,30,9
2022,GRC,Sabah,12,8,4
2022,GRC,Sarawak,16,9,7
2022,GRC,Selangor,1233,880,353
2022,GRD,Johor,51,34,17
2022,GRD,Kedah,5,4,1
2022,GRD,Pulau Pinang,7,5,2
2022,GRD,Sabah,6,3,3
2022,GRD,Sarawak,4,3,1
2022,GRD,Selangor,64,48,16
2022,GRL,Johor,0,0,0
2022,GRL,Selangor,0,0,0
2022,GTM,Johor,9,3,6
2022,GTM,Kedah,0,0,0
2022,GTM,Pahang,0,0,0
2022,GTM,Perak,2,1,1
2022,GTM,Pulau Pinang,6,3,3
2022,GTM,Sabah,0,0,0
2022,GTM,Sarawak,0,0,0
2022,GTM,Selangor,101,55,46
2022,GTM,W.P. Labuan,0,0,0
2022,GUY,Johor,4,3,1
2022,GUY,Kedah,0,0,0
2022,GUY,Pulau Pinang,0,0,0
2022,GUY,Sarawak,0,0,0
2022,GUY,Selangor,24,16,8
2022,HKG,Johor,33,18,15
2022,HKG,Kedah,51,21,30
2022,HKG,Kelantan,0,0,0
2022,HKG,Pahang,9,6,3
2022,HKG,Perak,195,95,100
2022,HKG,Perlis,20,12,8
2022,HKG,Pulau Pinang,366,220,146
2022,HKG,Sabah,235,108,127
2022,HKG,Sarawak,279,179,100
2022,HKG,Selangor,192,107,85
2022,HKG,Terengganu,0,0,0
2022,HMD,Johor,0,0,0
2022,HND,Johor,28,13,15
2022,HND,Kedah,1,0,1
2022,HND,Perak,2,1,1
2022,HND,Pulau Pinang,6,3,3
2022,HND,Sabah,1,1,0
2022,HND,Sarawak,0,0,0
2022,HND,Selangor,76,38,38
2022,HRV,Johor,193,151,42
2022,HRV,Kedah,16,5,11
2022,HRV,Kelantan,0,0,0
2022,HRV,Melaka,0,0,0
2022,HRV,Pahang,1,1,0
2022,HRV,Perak,3,2,1
2022,HRV,Perlis,0,0,0
2022,HRV,Pulau Pinang,25,15,10
2022,HRV,Sabah,12,10,2
2022,HRV,Sarawak,13,10,3
2022,HRV,Selangor,1007,741,266
2022,HTI,Johor,12,8,4
2022,HTI,Kedah,1,0,1
2022,HTI,Kelantan,0,0,0
2022,HTI,Perak,1,1,0
2022,HTI,Pulau Pinang,1,0,1
2022,HTI,Sabah,0,0,0
2022,HTI,Selangor,31,17,14
2022,HUN,Johor,681,460,221
2022,HUN,Kedah,100,47,53
2022,HUN,Kelantan,3,3,0
2022,HUN,Pahang,4,3,1
2022,HUN,Perak,4,2,2
2022,HUN,Perlis,16,11,5
2022,HUN,Pulau Pinang,119,67,52
2022,HUN,Sabah,103,53,50
2022,HUN,Sarawak,31,20,11
2022,HUN,Selangor,2270,1233,1037
2022,HUN,W.P. Labuan,0,0,0
2022,IDN,Johor,672959,355991,316968
2022,IDN,Kedah,17991,6857,11134
2022,IDN,Kelantan,782,529,253
2022,IDN,Melaka,48981,21721,27260
2022,IDN,Negeri Sembilan,50068,33929,16139
2022,IDN,Pahang,80,61,19
2022,IDN,Perak,997,332,665
2022,IDN,Perlis,2038,854,1184
2022,IDN,Pulau Pinang,167855,64759,103096
2022,IDN,Sabah,30060,14540,15520
2022,IDN,Sarawak,207007,117261,89746
2022,IDN,Selangor,542962,263905,279057
2022,IDN,Terengganu,3,2,1
2022,IDN,W.P. Labuan,255,160,95
2022,IND,Johor,108225,74214,34011
2022,IND,Kedah,5444,3436,2008
2022,IND,Kelantan,36,30,6
2022,IND,Melaka,18,12,6
2022,IND,Negeri Sembilan,2,2,0
2022,IND,Pahang,14,9,5
2022,IND,Perak,3500,2933,567
2022,IND,Perlis,528,450,78
2022,IND,Pulau Pinang,5898,4261,1637
2022,IND,Sabah,1428,941,487
2022,IND,Sarawak,3139,2416,723
2022,IND,Selangor,343938,248744,95194
2022,IND,Terengganu,1,1,0
2022,IND,W.P. Labuan,155,122,33
2022,IOT,Pulau Pinang,1,1,0
2022,IOT,Selangor,1,1,0
2022,IRL,Johor,1974,1330,644
2022,IRL,Kedah,373,208,165
2022,IRL,Kelantan,0,0,0
2022,IRL,Negeri Sembilan,0,0,0
2022,IRL,Pahang,2,1,1
2022,IRL,Perak,50,22,28
2022,IRL,Perlis,90,53,37
2022,IRL,Pulau Pinang,540,350,190
2022,IRL,Sabah,132,67,65
2022,IRL,Sarawak,172,97,75
2022,IRL,Selangor,7726,4632,3094
2022,IRL,Terengganu,0,0,0
2022,IRL,W.P. Labuan,1,1,0
2022,IRN,Johor,762,486,276
2022,IRN,Kedah,39,27,12
2022,IRN,Kelantan,0,0,0
2022,IRN,Perak,2,2,0
2022,IRN,Perlis,13,11,2
2022,IRN,Pulau Pinang,43,24,19
2022,IRN,Sabah,18,14,4
2022,IRN,Sarawak,27,13,14
2022,IRN,Selangor,9245,5070,4175
2022,IRN,W.P. Labuan,0,0,0
2022,IRQ,Johor,128,101,27
2022,IRQ,Kedah,12,5,7
2022,IRQ,Kelantan,0,0,0
2022,IRQ,Melaka,4,3,1
2022,IRQ,Pahang,0,0,0
2022,IRQ,Perak,0,0,0
2022,IRQ,Perlis,2,2,0
2022,IRQ,Pulau Pinang,7,7,0
2022,IRQ,Sabah,1,1,0
2022,IRQ,Sarawak,2,1,1
2022,IRQ,Selangor,6913,4657,2256
2022,ISL,Johor,67,33,34
2022,ISL,Kedah,4,4,0
2022,ISL,Kelantan,1,0,1
2022,ISL,Perak,4,2,2
2022,ISL,Perlis,2,2,0
2022,ISL,Pulau Pinang,17,11,6
2022,ISL,Sabah,20,11,9
2022,ISL,Sarawak,10,5,5
2022,ISL,Selangor,156,87,69
2022,ISL,W.P. Labuan,0,0,0
2022,ISR,Pulau Pinang,7,5,2
2022,ITA,Johor,3970,2758,1212
2022,ITA,Kedah,529,323,206
2022,ITA,Kelantan,18,10,8
2022,ITA,Melaka,2,1,1
2022,ITA,Negeri Sembilan,2,1,1
2022,ITA,Pahang,6,5,1
2022,ITA,Perak,35,25,10
2022,ITA,Perlis,96,58,38
2022,ITA,Pulau Pinang,661,474,187
2022,ITA,Sabah,257,148,109
2022,ITA,Sarawak,357,218,139
2022,ITA,Selangor,17603,11686,5917
2022,ITA,W.P. Labuan,2,1,1
2022,JAM,Johor,14,5,9
2022,JAM,Kedah,3,0,3
2022,JAM,Perak,1,0,1
2022,JAM,Pulau Pinang,8,4,4
2022,JAM,Sabah,7,4,3
2022,JAM,Sarawak,1,1,0
2022,JAM,Selangor,88,52,36
2022,JAM,W.P. Labuan,0,0,0
2022,JOR,Johor,104,61,43
2022,JOR,Kedah,28,19,9
2022,JOR,Kelantan,0,0,0
2022,JOR,Melaka,0,0,0
2022,JOR,Perlis,5,5,0
2022,JOR,Pulau Pinang,35,25,10
2022,JOR,Sabah,4,4,0
2022,JOR,Sarawak,9,9,0
2022,JOR,Selangor,5220,3226,1994
2022,JOR,W.P. Labuan,1,1,0
2022,JPN,Johor,35488,25303,10185
2022,JPN,Kedah,1239,661,578
2022,JPN,Kelantan,28,21,7
2022,JPN,Melaka,5,4,1
2022,JPN,Negeri Sembilan,2,0,2
2022,JPN,Pahang,18,9,9
2022,JPN,Perak,236,155,81
2022,JPN,Perlis,238,178,60
2022,JPN,Pulau Pinang,6623,4754,1869
2022,JPN,Sabah,1574,844,730
2022,JPN,Sarawak,893,553,340
2022,JPN,Selangor,80647,53677,26970
2022,JPN,W.P. Labuan,26,20,6
2022,KAZ,Johor,259,131,128
2022,KAZ,Kedah,57,27,30
2022,KAZ,Kelantan,9,4,5
2022,KAZ,Melaka,0,0,0
2022,KAZ,Perak,1,1,0
2022,KAZ,Perlis,31,17,14
2022,KAZ,Pulau Pinang,37,19,18
2022,KAZ,Sabah,14,8,6
2022,KAZ,Sarawak,21,3,18
2022,KAZ,Selangor,3140,1303,1837
2022,KAZ,W.P. Labuan,0,0,0
2022,KEN,Johor,339,155,184
2022,KEN,Kedah,30,16,14
2022,KEN,Kelantan,1,0,1
2022,KEN,Perak,2,1,1
2022,KEN,Perlis,3,3,0
2022,KEN,Pulau Pinang,13,5,8
2022,KEN,Sabah,10,6,4
2022,KEN,Sarawak,9,4,5
2022,KEN,Selangor,2190,1146,1044
2022,KGZ,Johor,119,48,71
2022,KGZ,Kedah,3,3,0
2022,KGZ,Kelantan,1,0,1
2022,KGZ,Perak,0,0,0
2022,KGZ,Perlis,0,0,0
2022,KGZ,Pulau Pinang,2,1,1
2022,KGZ,Sabah,0,0,0
2022,KGZ,Sarawak,1,0,1
2022,KGZ,Selangor,1277,715,562
2022,KHM,Johor,10538,4449,6089
2022,KHM,Kedah,2611,1864,747
2022,KHM,Kelantan,3061,1804,1257
2022,KHM,Melaka,15,4,11
2022,KHM,Negeri Sembilan,0,0,0
2022,KHM,Pahang,0,0,0
2022,KHM,Perak,78,56,22
2022,KHM,Perlis,5210,3444,1766
2022,KHM,Pulau Pinang,246,125,121
2022,KHM,Sabah,6,2,4
2022,KHM,Sarawak,29,16,13
2022,KHM,Selangor,27537,13804,13733
2022,KHM,W.P. Labuan,0,0,0
2022,KIR,Johor,0,0,0
2022,KIR,Sabah,1,0,1
2022,KIR,Selangor,4,3,1
2022,KNA,Johor,164,115,49
2022,KNA,Kedah,6,3,3
2022,KNA,Perlis,1,1,0
2022,KNA,Pulau Pinang,17,16,1
2022,KNA,Sabah,3,1,2
2022,KNA,Selangor,373,268,105
2022,KNA,W.P. Labuan,0,0,0
2022,KOR,Johor,61449,35099,26350
2022,KOR,Kedah,898,423,475
2022,KOR,Kelantan,1,1,0
2022,KOR,Melaka,13,12,1
2022,KOR,Negeri Sembilan,1,1,0
2022,KOR,Pahang,11,4,7
2022,KOR,Perak,107,61,46
2022,KOR,Perlis,323,240,83
2022,KOR,Pulau Pinang,2794,1634,1160
2022,KOR,Sabah,53795,23684,30111
2022,KOR,Sarawak,1146,706,440
2022,KOR,Selangor,67390,39874,27516
2022,KOR,Terengganu,0,0,0
2022,KOR,W.P. Labuan,13,8,5
2022,KWT,Johor,305,163,142
2022,KWT,Kedah,87,44,43
2022,KWT,Kelantan,1,1,0
2022,KWT,Perak,1,1,0
2022,KWT,Perlis,3,1,2
2022,KWT,Pulau Pinang,63,33,30
2022,KWT,Sabah,2,0,2
2022,KWT,Sarawak,14,8,6
2022,KWT,Selangor,4184,2301,1883
2022,KWT,W.P. Labuan,0,0,0
2022,LAO,Johor,642,186,456
2022,LAO,Kedah,4317,499,3818
2022,LAO,Kelantan,526,42,484
2022,LAO,Melaka,1,0,1
2022,LAO,Perak,81,14,67
2022,LAO,Perlis,1465,403,1062
2022,LAO,Pulau Pinang,135,48,87
2022,LAO,Sabah,17,5,12
2022,LAO,Sarawak,30,17,13
2022,LAO,Selangor,2348,1203,1145
2022,LAO,W.P. Labuan,0,0,0
2022,LBN,Johor,96,62,34
2022,LBN,Kedah,16,9,7
2022,LBN,Kelantan,0,0,0
2022,LBN,Pahang,0,0,0
2022,LBN,Perak,0,0,0
2022,LBN,Perlis,1,1,0
2022,LBN,Pulau Pinang,27,16,11
2022,LBN,Sabah,5,3,2
2022,LBN,Sarawak,7,5,2
2022,LBN,Selangor,1581,1031,550
2022,LBN,W.P. Labuan,1,1,0
2022,LBR,Johor,10,10,0
2022,LBR,Kedah,1,1,0
2022,LBR,Sabah,1,1,0
2022,LBR,Sarawak,0,0,0
2022,LBR,Selangor,71,54,17
2022,LBY,Johor,16,12,4
2022,LBY,Kedah,1,1,0
2022,LBY,Perlis,0,0,0
2022,LBY,Pulau Pinang,5,5,0
2022,LBY,Sabah,3,3,0
2022,LBY,Sarawak,13,7,6
2022,LBY,Selangor,2611,1790,821
2022,LCA,Johor,43,37,6
2022,LCA,Kedah,0,0,0
2022,LCA,Pulau Pinang,1,0,1
2022,LCA,Sarawak,6,3,3
2022,LCA,Selangor,47,36,11
2022,LIE,Johor,12,10,2
2022,LIE,Kedah,5,3,2
2022,LIE,Perlis,0,0,0
2022,LIE,Pulau Pinang,6,5,1
2022,LIE,Sabah,2,1,1
2022,LIE,Sarawak,0,0,0
2022,LIE,Selangor,28,21,7
2022,LKA,Johor,6673,4403,2270
2022,LKA,Kedah,181,104,77
2022,LKA,Kelantan,0,0,0
2022,LKA,Melaka,0,0,0
2022,LKA,Pahang,0,0,0
2022,LKA,Perak,32,17,15
2022,LKA,Perlis,6,3,3
2022,LKA,Pulau Pinang,175,118,57
2022,LKA,Sabah,60,38,22
2022,LKA,Sarawak,109,73,36
2022,LKA,Selangor,22812,14472,8340
2022,LKA,W.P. Labuan,2,2,0
2022,LSO,Johor,2,1,1
2022,LSO,Kedah,0,0,0
2022,LSO,Pulau Pinang,0,0,0
2022,LSO,Sarawak,0,0,0
2022,LSO,Selangor,50,22,28
2022,LTU,Johor,209,86,123
2022,LTU,Kedah,66,29,37
2022,LTU,Kelantan,1,0,1
2022,LTU,Pahang,1,0,1
2022,LTU,Perak,8,2,6
2022,LTU,Perlis,20,11,9
2022,LTU,Pulau Pinang,48,26,22
2022,LTU,Sabah,33,24,9
2022,LTU,Sarawak,27,13,14
2022,LTU,Selangor,1192,662,530
2022,LTU,W.P. Labuan,0,0,0
2022,LUX,Johor,53,22,31
2022,LUX,Kedah,13,9,4
2022,LUX,Kelantan,0,0,0
2022,LUX,Perak,0,0,0
2022,LUX,Perlis,3,2,1
2022,LUX,Pulau Pinang,16,9,7
2022,LUX,Sabah,2,1,1
2022,LUX,Sarawak,3,2,1
2022,LUX,Selangor,255,150,105
2022,LVA,Johor,122,62,60
2022,LVA,Kedah,49,20,29
2022,LVA,Kelantan,0,0,0
2022,LVA,Pahang,0,0,0
2022,LVA,Perak,1,1,0
2022,LVA,Perlis,8,4,4
2022,LVA,Pulau Pinang,14,5,9
2022,LVA,Sabah,14,4,10
2022,LVA,Sarawak,32,16,16
2022,LVA,Selangor,603,315,288
2022,LVA,W.P. Labuan,13,6,7
2022,MAC,Johor,2,0,2
2022,MAC,Pahang,0,0,0
2022,MAC,Perak,4,2,2
2022,MAC,Selangor,9,2,7
2022,MAC,W.P. Labuan,1,1,0
2022,MAR,Johor,507,328,179
2022,MAR,Kedah,32,19,13
2022,MAR,Kelantan,5,5,0
2022,MAR,Melaka,2,0,2
2022,MAR,Pahang,0,0,0
2022,MAR,Perak,0,0,0
2022,MAR,Perlis,10,7,3
2022,MAR,Pulau Pinang,53,39,14
2022,MAR,Sabah,15,8,7
2022,MAR,Sarawak,26,21,5
2022,MAR,Selangor,4502,2238,2264
2022,MAR,W.P. Labuan,1,1,0
2022,MCO,Johor,7,6,1
2022,MCO,Kedah,0,0,0
2022,MCO,Sabah,0,0,0
2022,MCO,Selangor,15,3,12
2022,MDA,Johor,25,13,12
2022,MDA,Kedah,2,1,1
2022,MDA,Kelantan,0,0,0
2022,MDA,Negeri Sembilan,0,0,0
2022,MDA,Perlis,0,0,0
2022,MDA,Pulau Pinang,5,4,1
2022,MDA,Sabah,2,0,2
2022,MDA,Sarawak,5,0,5
2022,MDA,Selangor,153,81,72
2022,MDG,Johor,32,12,20
2022,MDG,Kedah,1,1,0
2022,MDG,Perak,2,0,2
2022,MDG,Perlis,0,0,0
2022,MDG,Pulau Pinang,2,0,2
2022,MDG,Sabah,0,0,0
2022,MDG,Sarawak,0,0,0
2022,MDG,Selangor,142,53,89
2022,MDV,Johor,1041,605,436
2022,MDV,Kedah,107,55,52
2022,MDV,Kelantan,1,1,0
2022,MDV,Perak,9,4,5
2022,MDV,Perlis,11,8,3
2022,MDV,Pulau Pinang,51,34,17
2022,MDV,Sabah,7,3,4
2022,MDV,Sarawak,17,11,6
2022,MDV,Selangor,18985,9599,9386
2022,MEX,Johor,750,385,365
2022,MEX,Kedah,53,24,29
2022,MEX,Kelantan,0,0,0
2022,MEX,Pahang,0,0,0
2022,MEX,Perak,4,2,2
2022,MEX,Perlis,7,5,2
2022,MEX,Pulau Pinang,247,192,55
2022,MEX,Sabah,36,19,17
2022,MEX,Sarawak,18,10,8
2022,MEX,Selangor,2979,1619,1360
2022,MEX,W.P. Labuan,0,0,0
2022,MHL,Johor,5,2,3
2022,MHL,Kedah,1,1,0
2022,MHL,Perak,0,0,0
2022,MHL,Pulau Pinang,1,1,0
2022,MHL,Sabah,0,0,0
2022,MHL,Selangor,11,9,2
2022,MKD,Johor,34,15,19
2022,MKD,Kedah,5,3,2
2022,MKD,Perak,2,0,2
2022,MKD,Pulau Pinang,10,10,0
2022,MKD,Sabah,0,0,0
2022,MKD,Sarawak,6,2,4
2022,MKD,Selangor,148,87,61
2022,MLI,Johor,17,17,0
2022,MLI,Sabah,0,0,0
2022,MLI,Selangor,36,28,8
2022,MLT,Johor,48,31,17
2022,MLT,Kedah,21,12,9
2022,MLT,Kelantan,0,0,0
2022,MLT,Perak,2,1,1
2022,MLT,Perlis,1,1,0
2022,MLT,Pulau Pinang,51,33,18
2022,MLT,Sabah,9,6,3
2022,MLT,Sarawak,5,3,2
2022,MLT,Selangor,290,173,117
2022,MLT,W.P. Labuan,0,0,0
2022,MMR,Johor,24372,7510,16862
2022,MMR,Kedah,266,59,207
2022,MMR,Kelantan,10,4,6
2022,MMR,Negeri Sembilan,0,0,0
2022,MMR,Pahang,0,0,0
2022,MMR,Perak,121,36,85
2022,MMR,Perlis,43,7,36
2022,MMR,Pulau Pinang,882,361,521
2022,MMR,Sabah,103,35,68
2022,MMR,Sarawak,340,138,202
2022,MMR,Selangor,48789,33246,15543
2022,MMR,Terengganu,0,0,0
2022,MMR,W.P. Labuan,1,1,0
2022,MNE,Johor,7,7,0
2022,MNE,Kedah,0,0,0
2022,MNE,Pulau Pinang,0,0,0
2022,MNE,Sabah,0,0,0
2022,MNE,Sarawak,2,2,0
2022,MNE,Selangor,76,68,8
2022,MNG,Johor,910,397,513
2022,MNG,Kedah,29,8,21
2022,MNG,Kelantan,0,0,0
2022,MNG,Perak,2,0,2
2022,MNG,Perlis,17,11,6
2022,MNG,Pulau Pinang,62,27,35
2022,MNG,Sabah,46,22,24
2022,MNG,Sarawak,4,4,0
2022,MNG,Selangor,1798,759,1039
2022,MNP,Selangor,0,0,0
2022,MOZ,Johor,12,8,4
2022,MOZ,Kedah,11,7,4
2022,MOZ,Perak,0,0,0
2022,MOZ,Pulau Pinang,0,0,0
2022,MOZ,Sabah,0,0,0
2022,MOZ,Sarawak,1,1,0
2022,MOZ,Selangor,180,102,78
2022,MRT,Johor,22,17,5
2022,MRT,Kedah,1,1,0
2022,MRT,Pulau Pinang,0,0,0
2022,MRT,Sabah,1,1,0
2022,MRT,Sarawak,0,0,0
2022,MRT,Selangor,192,161,31
2022,MUS,Johor,807,436,371
2022,MUS,Kedah,22,10,12
2022,MUS,Kelantan,2,1,1
2022,MUS,Pahang,0,0,0
2022,MUS,Perak,8,2,6
2022,MUS,Perlis,7,4,3
2022,MUS,Pulau Pinang,56,30,26
2022,MUS,Sabah,3,2,1
2022,MUS,Sarawak,4,2,2
2022,MUS,Selangor,5575,2770,2805
2022,MWI,Johor,11,4,7
2022,MWI,Pulau Pinang,2,1,1
2022,MWI,Sabah,1,0,1
2022,MWI,Sarawak,3,0,3
2022,MWI,Selangor,157,88,69
2022,MYT,Selangor,0,0,0
2022,NAM,Johor,11,5,6
2022,NAM,Kedah,1,0,1
2022,NAM,Perak,2,1,1
2022,NAM,Perlis,1,0,1
2022,NAM,Pulau Pinang,2,0,2
2022,NAM,Sabah,0,0,0
2022,NAM,Sarawak,0,0,0
2022,NAM,Selangor,99,40,59
2022,NCL,Selangor,1,1,0
2022,NER,Johor,2,2,0
2022,NER,Sabah,0,0,0
2022,NER,Selangor,21,11,10
2022,NGA,Johor,204,169,35
2022,NGA,Kedah,9,9,0
2022,NGA,Perlis,0,0,0
2022,NGA,Pulau Pinang,21,19,2
2022,NGA,Sabah,2,2,0
2022,NGA,Sarawak,48,32,16
2022,NGA,Selangor,3536,2819,717
2022,NIC,Johor,11,5,6
2022,NIC,Kedah,0,0,0
2022,NIC,Pulau Pinang,4,3,1
2022,NIC,Sabah,0,0,0
2022,NIC,Selangor,47,21,26
2022,NLD,Johor,6944,4523,2421
2022,NLD,Kedah,1053,579,474
2022,NLD,Kelantan,17,13,4
2022,NLD,Melaka,8,5,3
2022,NLD,Negeri Sembilan,11,6,5
2022,NLD,Pahang,10,8,2
2022,NLD,Perak,85,49,36
2022,NLD,Perlis,191,117,74
2022,NLD,Pulau Pinang,1394,890,504
2022,NLD,Sabah,531,289,242
2022,NLD,Sarawak,844,495,349
2022,NLD,Selangor,25899,15821,10078
2022,NLD,Terengganu,0,0,0
2022,NLD,W.P. Labuan,7,3,4
2022,NOR,Johor,1070,718,352
2022,NOR,Kedah,140,82,58
2022,NOR,Kelantan,4,4,0
2022,NOR,Melaka,0,0,0
2022,NOR,Pahang,0,0,0
2022,NOR,Perak,3,2,1
2022,NOR,Perlis,38,22,16
2022,NOR,Pulau Pinang,167,101,66
2022,NOR,Sabah,91,67,24
2022,NOR,Sarawak,87,64,23
2022,NOR,Selangor,4291,2719,1572
2022,NOR,W.P. Labuan,2,1,1
2022,NPL,Johor,3626,2927,699
2022,NPL,Kedah,39,28,11
2022,NPL,Pahang,0,0,0
2022,NPL,Perak,1,1,0
2022,NPL,Perlis,5,5,0
2022,NPL,Pulau Pinang,156,131,25
2022,NPL,Sabah,57,39,18
2022,NPL,Sarawak,998,680,318
2022,NPL,Selangor,174655,167765,6890
2022,NPL,W.P. Labuan,360,344,16
2022,NRU,Johor,0,0,0
2022,NRU,Pulau Pinang,0,0,0
2022,NRU,Selangor,9,7,2
2022,NZL,Johor,4433,2743,1690
2022,NZL,Kedah,432,245,187
2022,NZL,Kelantan,8,5,3
2022,NZL,Melaka,1,1,0
2022,NZL,Negeri Sembilan,1,1,0
2022,NZL,Pahang,11,7,4
2022,NZL,Perak,117,70,47
2022,NZL,Perlis,63,41,22
2022,NZL,Pulau Pinang,1125,653,472
2022,NZL,Sabah,360,198,162
2022,NZL,Sarawak,614,345,269
2022,NZL,Selangor,14743,8972,5771
2022,NZL,Terengganu,1,1,0
2022,NZL,W.P. Labuan,9,6,3
2022,OMN,Johor,535,293,242
2022,OMN,Kedah,21,15,6
2022,OMN,Kelantan,3,2,1
2022,OMN,Melaka,0,0,0
2022,OMN,Perak,0,0,0
2022,OMN,Perlis,1,1,0
2022,OMN,Pulau Pinang,40,28,12
2022,OMN,Sabah,9,4,5
2022,OMN,Sarawak,73,39,34
2022,OMN,Selangor,6600,4046,2554
2022,PAK,Johor,5457,4020,1437
2022,PAK,Kedah,682,509,173
2022,PAK,Kelantan,93,92,1
2022,PAK,Melaka,1,1,0
2022,PAK,Negeri Sembilan,3,3,0
2022,PAK,Pahang,5,2,3
2022,PAK,Perak,257,250,7
2022,PAK,Perlis,161,151,10
2022,PAK,Pulau Pinang,263,226,37
2022,PAK,Sabah,82,71,11
2022,PAK,Sarawak,513,404,109
2022,PAK,Selangor,80722,68991,11731
2022,PAK,W.P. Labuan,21,17,4
2022,PAN,Johor,28,13,15
2022,PAN,Kedah,1,0,1
2022,PAN,Perak,0,0,0
2022,PAN,Perlis,1,0,1
2022,PAN,Pulau Pinang,5,3,2
2022,PAN,Sabah,1,1,0
2022,PAN,Sarawak,3,1,2
2022,PAN,Selangor,99,49,50
2022,PER,Johor,224,133,91
2022,PER,Kedah,15,7,8
2022,PER,Kelantan,0,0,0
2022,PER,Pahang,0,0,0
2022,PER,Perak,0,0,0
2022,PER,Perlis,7,1,6
2022,PER,Pulau Pinang,28,13,15
2022,PER,Sabah,3,2,1
2022,PER,Sarawak,6,3,3
2022,PER,Selangor,606,322,284
2022,PER,W.P. Labuan,0,0,0
2022,PHL,Johor,113495,35509,77986
2022,PHL,Kedah,2238,804,1434
2022,PHL,Kelantan,92,50,42
2022,PHL,Melaka,4,1,3
2022,PHL,Negeri Sembilan,1,1,0
2022,PHL,Pahang,65,54,11
2022,PHL,Perak,396,140,256
2022,PHL,Perlis,897,326,571
2022,PHL,Pulau Pinang,3140,1182,1958
2022,PHL,Sabah,6834,2912,3922
2022,PHL,Sarawak,6324,2496,3828
2022,PHL,Selangor,100503,41159,59344
2022,PHL,Terengganu,2,2,0
2022,PHL,W.P. Labuan,372,144,228
2022,PLW,Johor,9,9,0
2022,PLW,Pulau Pinang,0,0,0
2022,PLW,Selangor,6,4,2
2022,PNG,Johor,86,53,33
2022,PNG,Kedah,1,1,0
2022,PNG,Kelantan,0,0,0
2022,PNG,Perak,1,1,0
2022,PNG,Pulau Pinang,10,5,5
2022,PNG,Sabah,2,0,2
2022,PNG,Sarawak,22,8,14
2022,PNG,Selangor,328,190,138
2022,POL,Johor,2160,1230,930
2022,POL,Kedah,316,146,170
2022,POL,Kelantan,9,5,4
2022,POL,Melaka,1,1,0
2022,POL,Negeri Sembilan,0,0,0
2022,POL,Pahang,0,0,0
2022,POL,Perak,19,11,8
2022,POL,Perlis,70,44,26
2022,POL,Pulau Pinang,370,203,167
2022,POL,Sabah,206,110,96
2022,POL,Sarawak,198,94,104
2022,POL,Selangor,6283,3475,2808
2022,POL,Terengganu,0,0,0
2022,POL,W.P. Labuan,14,8,6
2022,PRK,Selangor,0,0,0
2022,PRT,Johor,970,545,425
2022,PRT,Kedah,141,80,61
2022,PRT,Kelantan,1,1,0
2022,PRT,Melaka,1,1,0
2022,PRT,Pahang,0,0,0
2022,PRT,Perak,16,9,7
2022,PRT,Perlis,19,11,8
2022,PRT,Pulau Pinang,201,114,87
2022,PRT,Sabah,65,35,30
2022,PRT,Sarawak,38,22,16
2022,PRT,Selangor,4357,2625,1732
2022,PRT,W.P. Labuan,3,1,2
2022,PRY,Johor,12,8,4
2022,PRY,Kedah,0,0,0
2022,PRY,Perak,2,1,1
2022,PRY,Perlis,0,0,0
2022,PRY,Pulau Pinang,7,6,1
2022,PRY,Sabah,5,3,2
2022,PRY,Sarawak,0,0,0
2022,PRY,Selangor,47,25,22
2022,PSE,Johor,46,31,15
2022,PSE,Kedah,7,4,3
2022,PSE,Kelantan,3,2,1
2022,PSE,Melaka,0,0,0
2022,PSE,Perak,0,0,0
2022,PSE,Perlis,3,3,0
2022,PSE,Pulau Pinang,6,4,2
2022,PSE,Sabah,1,1,0
2022,PSE,Sarawak,12,9,3
2022,PSE,Selangor,2381,1620,761
2022,QAT,Johor,150,73,77
2022,QAT,Kedah,1,0,1
2022,QAT,Perlis,0,0,0
2022,QAT,Pulau Pinang,5,4,1
2022,QAT,Sabah,0,0,0
2022,QAT,Sarawak,8,5,3
2022,QAT,Selangor,1212,716,496
2022,REU,Johor,0,0,0
2022,REU,Sarawak,0,0,0
2022,ROU,Johor,811,443,368
2022,ROU,Kedah,78,40,38
2022,ROU,Kelantan,2,0,2
2022,ROU,Negeri Sembilan,0,0,0
2022,ROU,Pahang,0,0,0
2022,ROU,Perak,13,6,7
2022,ROU,Perlis,9,7,2
2022,ROU,Pulau Pinang,109,59,50
2022,ROU,Sabah,37,18,19
2022,ROU,Sarawak,47,28,19
2022,ROU,Selangor,3328,1857,1471
2022,ROU,W.P. Labuan,1,1,0
2022,RUS,Johor,2358,1266,1092
2022,RUS,Kedah,1853,985,868
2022,RUS,Kelantan,152,93,59
2022,RUS,Melaka,3,2,1
2022,RUS,Negeri Sembilan,0,0,0
2022,RUS,Pahang,3,0,3
2022,RUS,Perak,17,7,10
2022,RUS,Perlis,1358,792,566
2022,RUS,Pulau Pinang,1153,639,514
2022,RUS,Sabah,155,81,74
2022,RUS,Sarawak,259,128,131
2022,RUS,Selangor,33413,18236,15177
2022,RUS,W.P. Labuan,6,3,3
2022,RWA,Johor,7,5,2
2022,RWA,Kedah,0,0,0
2022,RWA,Pulau Pinang,0,0,0
2022,RWA,Selangor,52,26,26
2022,SAU,Johor,975,585,390
2022,SAU,Kedah,167,100,67
2022,SAU,Kelantan,32,16,16
2022,SAU,Melaka,2,2,0
2022,SAU,Perak,14,4,10
2022,SAU,Perlis,49,37,12
2022,SAU,Pulau Pinang,174,91,83
2022,SAU,Sabah,35,29,6
2022,SAU,Sarawak,97,74,23
2022,SAU,Selangor,37250,20242,17008
2022,SAU,W.P. Labuan,1,1,0
2022,SDN,Johor,58,33,25
2022,SDN,Kedah,5,5,0
2022,SDN,Kelantan,0,0,0
2022,SDN,Perlis,1,0,1
2022,SDN,Pulau Pinang,6,4,2
2022,SDN,Sabah,0,0,0
2022,SDN,Sarawak,23,16,7
2022,SDN,Selangor,7318,4272,3046
2022,SDN,W.P. Labuan,4,4,0
2022,SEN,Johor,12,8,4
2022,SEN,Kedah,4,1,3
2022,SEN,Kelantan,1,1,0
2022,SEN,Perak,1,0,1
2022,SEN,Perlis,0,0,0
2022,SEN,Pulau Pinang,3,0,3
2022,SEN,Sabah,1,1,0
2022,SEN,Sarawak,1,1,0
2022,SEN,Selangor,206,149,57
2022,SGP,Johor,7829939,4581072,3248867
2022,SGP,Kedah,25315,13310,12005
2022,SGP,Kelantan,316,207,109
2022,SGP,Melaka,106,78,28
2022,SGP,Negeri Sembilan,78,37,41
2022,SGP,Pahang,957,546,411
2022,SGP,Perak,36438,17223,19215
2022,SGP,Perlis,1594,968,626
2022,SGP,Pulau Pinang,113253,57129,56124
2022,SGP,Sabah,22632,11646,10986
2022,SGP,Sarawak,26347,14695,11652
2022,SGP,Selangor,331989,173007,158982
2022,SGP,Terengganu,3,3,0
2022,SGP,W.P. Labuan,64,51,13
2022,SGS,Johor,0,0,0
2022,SGS,Sabah,0,0,0
2022,SGS,Selangor,4,4,0
2022,SHN,Sarawak,0,0,0
2022,SLB,Johor,7,7,0
2022,SLB,Perlis,1,1,0
2022,SLB,Pulau Pinang,0,0,0
2022,SLB,Sabah,2,2,0
2022,SLB,Sarawak,15,9,6
2022,SLB,Selangor,48,26,22
2022,SLB,W.P. Labuan,0,0,0
2022,SLE,Johor,6,3,3
2022,SLE,Kedah,0,0,0
2022,SLE,Perak,1,1,0
2022,SLE,Pulau Pinang,4,4,0
2022,SLE,Sabah,0,0,0
2022,SLE,Selangor,125,90,35
2022,SLV,Johor,12,7,5
2022,SLV,Kedah,4,2,2
2022,SLV,Perak,1,1,0
2022,SLV,Perlis,0,0,0
2022,SLV,Pulau Pinang,6,5,1
2022,SLV,Sabah,0,0,0
2022,SLV,Selangor,59,32,27
2022,SLV,W.P. Labuan,0,0,0
2022,SMR,Johor,0,0,0
2022,SMR,Selangor,8,7,1
2022,SOM,Johor,3,3,0
2022,SOM,Kedah,0,0,0
2022,SOM,Kelantan,0,0,0
2022,SOM,Perlis,0,0,0
2022,SOM,Sabah,0,0,0
2022,SOM,Sarawak,1,1,0
2022,SOM,Selangor,1857,1170,687
2022,SRB,Johor,58,38,20
2022,SRB,Kedah,3,2,1
2022,SRB,Kelantan,1,1,0
2022,SRB,Pahang,1,1,0
2022,SRB,Perak,1,0,1
2022,SRB,Perlis,2,1,1
2022,SRB,Pulau Pinang,17,15,2
2022,SRB,Sabah,3,2,1
2022,SRB,Sarawak,2,1,1
2022,SRB,Selangor,366,215,151
2022,SSD,Johor,1,0,1
2022,SSD,Kedah,0,0,0
2022,SSD,Sarawak,2,2,0
2022,SSD,Selangor,255,193,62
2022,SSD,W.P. Labuan,0,0,0
2022,STP,Selangor,9,5,4
2022,SUR,Johor,28,14,14
2022,SUR,Kedah,1,1,0
2022,SUR,Kelantan,0,0,0
2022,SUR,Perak,0,0,0
2022,SUR,Perlis,0,0,0
2022,SUR,Pulau Pinang,2,2,0
2022,SUR,Sabah,0,0,0
2022,SUR,Sarawak,0,0,0
2022,SUR,Selangor,77,40,37
2022,SVK,Johor,190,105,85
2022,SVK,Kedah,227,120,107
2022,SVK,Kelantan,3,0,3
2022,SVK,Negeri Sembilan,0,0,0
2022,SVK,Pahang,0,0,0
2022,SVK,Perak,0,0,0
2022,SVK,Perlis,7,3,4
2022,SVK,Pulau Pinang,66,49,17
2022,SVK,Sabah,39,21,18
2022,SVK,Sarawak,18,7,11
2022,SVK,Selangor,1638,912,726
2022,SVK,W.P. Labuan,0,0,0
2022,SVN,Johor,75,42,33
2022,SVN,Kedah,33,18,15
2022,SVN,Kelantan,1,1,0
2022,SVN,Perak,1,0,1
2022,SVN,Perlis,3,2,1
2022,SVN,Pulau Pinang,17,11,6
2022,SVN,Sabah,11,5,6
2022,SVN,Sarawak,17,9,8
2022,SVN,Selangor,488,299,189
2022,SVN,W.P. Labuan,0,0,0
2022,SWE,Johor,1724,1083,641
2022,SWE,Kedah,475,256,219
2022,SWE,Kelantan,45,21,24
2022,SWE,Melaka,1,1,0
2022,SWE,Negeri Sembilan,1,1,0
2022,SWE,Pahang,1,1,0
2022,SWE,Perak,33,19,14
2022,SWE,Perlis,71,50,21
2022,SWE,Pulau Pinang,408,282,126
2022,SWE,Sabah,159,94,65
2022,SWE,Sarawak,110,77,33
2022,SWE,Selangor,6387,4023,2364
2022,SWE,W.P. Labuan,6,6,0
2022,SWZ,Johor,2,2,0
2022,SWZ,Kedah,0,0,0
2022,SWZ,Pulau Pinang,1,1,0
2022,SWZ,Sabah,0,0,0
2022,SWZ,Selangor,125,57,68
2022,SYC,Johor,24,16,8
2022,SYC,Kedah,0,0,0
2022,SYC,Pulau Pinang,6,3,3
2022,SYC,Sabah,0,0,0
2022,SYC,Sarawak,8,6,2
2022,SYC,Selangor,467,185,282
2022,SYR,Johor,81,32,49
2022,SYR,Kedah,7,6,1
2022,SYR,Kelantan,0,0,0
2022,SYR,Pahang,6,6,0
2022,SYR,Perlis,2,1,1
2022,SYR,Pulau Pinang,7,7,0
2022,SYR,Sabah,0,0,0
2022,SYR,Sarawak,41,25,16
2022,SYR,Selangor,5108,3134,1974
2022,SYR,W.P. Labuan,2,2,0
2022,TCA,Perlis,0,0,0
2022,TCD,Johor,16,16,0
2022,TCD,Kedah,0,0,0
2022,TCD,Perlis,0,0,0
2022,TCD,Selangor,128,95,33
2022,TGO,Johor,9,5,4
2022,TGO,Perak,2,2,0
2022,TGO,Pulau Pinang,0,0,0
2022,TGO,Selangor,33,28,5
2022,THA,Johor,35197,9085,26112
2022,THA,Kedah,444544,302822,141722
2022,THA,Kelantan,180335,91129,89206
2022,THA,Melaka,51,19,32
2022,THA,Negeri Sembilan,11,4,7
2022,THA,Pahang,123,101,22
2022,THA,Perak,44788,20439,24349
2022,THA,Perlis,417388,272428,144960
2022,THA,Pulau Pinang,12914,5561,7353
2022,THA,Sabah,996,307,689
2022,THA,Sarawak,1250,509,741
2022,THA,Selangor,76017,31242,44775
2022,THA,Terengganu,4,3,1
2022,THA,W.P. Labuan,16,9,7
2022,TJK,Johor,11,10,1
2022,TJK,Kedah,5,4,1
2022,TJK,Perlis,1,1,0
2022,TJK,Pulau Pinang,2,0,2
2022,TJK,Sabah,3,2,1
2022,TJK,Selangor,714,501,213
2022,TKL,Selangor,0,0,0
2022,TKM,Johor,15,4,11
2022,TKM,Kedah,3,1,2
2022,TKM,Kelantan,0,0,0
2022,TKM,Perlis,0,0,0
2022,TKM,Pulau Pinang,0,0,0
2022,TKM,Sabah,1,1,0
2022,TKM,Sarawak,0,0,0
2022,TKM,Selangor,490,291,199
2022,TLS,Johor,128,111,17
2022,TLS,Kedah,4,3,1
2022,TLS,Perlis,0,0,0
2022,TLS,Pulau Pinang,28,16,12
2022,TLS,Sabah,5,3,2
2022,TLS,Sarawak,9,1,8
2022,TLS,Selangor,2136,1370,766
2022,TON,Johor,5,2,3
2022,TON,Pulau Pinang,7,1,6
2022,TON,Sarawak,0,0,0
2022,TON,Selangor,66,34,32
2022,TTO,Johor,22,10,12
2022,TTO,Kedah,4,2,2
2022,TTO,Pahang,0,0,0
2022,TTO,Pulau Pinang,3,1,2
2022,TTO,Sabah,1,0,1
2022,TTO,Sarawak,9,6,3
2022,TTO,Selangor,213,139,74
2022,TUN,Johor,84,46,38
2022,TUN,Kedah,16,7,9
2022,TUN,Kelantan,5,3,2
2022,TUN,Melaka,2,1,1
2022,TUN,Perak,0,0,0
2022,TUN,Perlis,3,2,1
2022,TUN,Pulau Pinang,24,18,6
2022,TUN,Sabah,6,4,2
2022,TUN,Sarawak,5,1,4
2022,TUN,Selangor,3047,1574,1473
2022,TUN,W.P. Labuan,0,0,0
2022,TUR,Johor,1608,1119,489
2022,TUR,Kedah,145,97,48
2022,TUR,Kelantan,16,15,1
2022,TUR,Melaka,1,1,0
2022,TUR,Negeri Sembilan,5,4,1
2022,TUR,Pahang,0,0,0
2022,TUR,Perak,8,7,1
2022,TUR,Perlis,66,51,15
2022,TUR,Pulau Pinang,157,100,57
2022,TUR,Sabah,33,22,11
2022,TUR,Sarawak,99,67,32
2022,TUR,Selangor,7079,5035,2044
2022,TUR,W.P. Labuan,0,0,0
2022,TUV,Selangor,1,0,1
2022,TWN,Johor,20908,8903,12005
2022,TWN,Kedah,461,236,225
2022,TWN,Kelantan,4,3,1
2022,TWN,Melaka,3,2,1
2022,TWN,Negeri Sembilan,3,1,2
2022,TWN,Pahang,9,6,3
2022,TWN,Perak,210,103,107
2022,TWN,Perlis,55,34,21
2022,TWN,Pulau Pinang,5383,3183,2200
2022,TWN,Sabah,843,398,445
2022,TWN,Sarawak,1017,478,539
2022,TWN,Selangor,30014,16205,13809
2022,TWN,W.P. Labuan,7,5,2
2022,TZA,Johor,87,48,39
2022,TZA,Kedah,0,0,0
2022,TZA,Perak,1,1,0
2022,TZA,Perlis,0,0,0
2022,TZA,Pulau Pinang,1,1,0
2022,TZA,Sabah,3,2,1
2022,TZA,Sarawak,4,4,0
2022,TZA,Selangor,1061,532,529
2022,UGA,Johor,69,40,29
2022,UGA,Kedah,10,4,6
2022,UGA,Perak,2,1,1
2022,UGA,Perlis,8,5,3
2022,UGA,Pulau Pinang,5,1,4
2022,UGA,Sabah,6,3,3
2022,UGA,Sarawak,0,0,0
2022,UGA,Selangor,584,298,286
2022,UKR,Johor,705,415,290
2022,UKR,Kedah,161,70,91
2022,UKR,Kelantan,12,5,7
2022,UKR,Melaka,11,11,0
2022,UKR,Negeri Sembilan,0,0,0
2022,UKR,Pahang,6,3,3
2022,UKR,Perak,3,2,1
2022,UKR,Perlis,96,41,55
2022,UKR,Pulau Pinang,150,60,90
2022,UKR,Sabah,34,18,16
2022,UKR,Sarawak,17,10,7
2022,UKR,Selangor,4235,2220,2015
2022,UKR,W.P. Labuan,2,0,2
2022,URY,Johor,63,22,41
2022,URY,Kedah,9,5,4
2022,URY,Kelantan,0,0,0
2022,URY,Perak,2,1,1
2022,URY,Perlis,0,0,0
2022,URY,Pulau Pinang,2,0,2
2022,URY,Sabah,3,3,0
2022,URY,Sarawak,2,1,1
2022,URY,Selangor,201,102,99
2022,URY,W.P. Labuan,0,0,0
2022,USA,Johor,25257,15563,9694
2022,USA,Kedah,2273,1286,987
2022,USA,Kelantan,54,39,15
2022,USA,Melaka,25,17,8
2022,USA,Negeri Sembilan,3,3,0
2022,USA,Pahang,26,17,9
2022,USA,Perak,683,376,307
2022,USA,Perlis,436,294,142
2022,USA,Pulau Pinang,10816,6761,4055
2022,USA,Sabah,2049,1148,901
2022,USA,Sarawak,1654,932,722
2022,USA,Selangor,83224,50103,33121
2022,USA,Terengganu,1,1,0
2022,USA,W.P. Labuan,35,27,8
2022,UZB,Johor,395,257,138
2022,UZB,Kedah,85,43,42
2022,UZB,Kelantan,0,0,0
2022,UZB,Perak,1,1,0
2022,UZB,Perlis,18,9,9
2022,UZB,Pulau Pinang,47,16,31
2022,UZB,Sabah,204,192,12
2022,UZB,Sarawak,4,3,1
2022,UZB,Selangor,5520,3235,2285
2022,VAT,Johor,5,4,1
2022,VAT,Sarawak,1,1,0
2022,VAT,Selangor,4,4,0
2022,VCT,Johor,1,1,0
2022,VCT,Kedah,0,0,0
2022,VCT,Pulau Pinang,0,0,0
2022,VCT,Sarawak,0,0,0
2022,VCT,Selangor,8,5,3
2022,VEN,Johor,65,38,27
2022,VEN,Kedah,5,2,3
2022,VEN,Kelantan,0,0,0
2022,VEN,Melaka,0,0,0
2022,VEN,Perak,0,0,0
2022,VEN,Perlis,0,0,0
2022,VEN,Pulau Pinang,6,2,4
2022,VEN,Sabah,5,3,2
2022,VEN,Sarawak,27,15,12
2022,VEN,Selangor,422,252,170
2022,VEN,W.P. Labuan,0,0,0
2022,VNM,Johor,92602,29578,63024
2022,VNM,Kedah,1772,272,1500
2022,VNM,Kelantan,61,44,17
2022,VNM,Melaka,3,0,3
2022,VNM,Negeri Sembilan,0,0,0
2022,VNM,Pahang,4,4,0
2022,VNM,Perak,632,56,576
2022,VNM,Perlis,1048,112,936
2022,VNM,Pulau Pinang,9222,2532,6690
2022,VNM,Sabah,151,50,101
2022,VNM,Sarawak,661,114,547
2022,VNM,Selangor,93955,31797,62158
2022,VNM,Terengganu,1,1,0
2022,VNM,W.P. Labuan,10,5,5
2022,VUT,Johor,170,117,53
2022,VUT,Kedah,4,4,0
2022,VUT,Pulau Pinang,14,11,3
2022,VUT,Sabah,5,4,1
2022,VUT,Sarawak,0,0,0
2022,VUT,Selangor,307,251,56
2022,WSM,Johor,4,4,0
2022,WSM,Sarawak,0,0,0
2022,WSM,Selangor,28,15,13
2022,XXX,Johor,1195,714,481
2022,XXX,Kedah,47,24,23
2022,XXX,Kelantan,2,0,2
2022,XXX,Melaka,0,0,0
2022,XXX,Pahang,0,0,0
2022,XXX,Perak,10,8,2
2022,XXX,Perlis,18,13,5
2022,XXX,Pulau Pinang,197,122,75
2022,XXX,Sabah,48,27,21
2022,XXX,Sarawak,123,92,31
2022,XXX,Selangor,2394,1430,964
2022,XXX,W.P. Labuan,4,4,0
2022,YEM,Johor,273,196,77
2022,YEM,Kedah,23,17,6
2022,YEM,Kelantan,5,5,0
2022,YEM,Melaka,10,6,4
2022,YEM,Pahang,1,1,0
2022,YEM,Perak,4,2,2
2022,YEM,Perlis,16,15,1
2022,YEM,Pulau Pinang,23,20,3
2022,YEM,Sabah,5,5,0
2022,YEM,Sarawak,17,13,4
2022,YEM,Selangor,11121,7554,3567
2022,YEM,W.P. Labuan,1,1,0
2022,ZAF,Johor,1893,1156,737
2022,ZAF,Kedah,207,110,97
2022,ZAF,Kelantan,3,2,1
2022,ZAF,Melaka,6,4,2
2022,ZAF,Pahang,2,2,0
2022,ZAF,Perak,18,12,6
2022,ZAF,Perlis,68,43,25
2022,ZAF,Pulau Pinang,336,192,144
2022,ZAF,Sabah,129,68,61
2022,ZAF,Sarawak,559,273,286
2022,ZAF,Selangor,7041,4078,2963
2022,ZAF,Terengganu,0,0,0
2022,ZAF,W.P. Labuan,23,10,13
2022,ZAR,Selangor,1,0,1
2022,ZMB,Johor,18,14,4
2022,ZMB,Kedah,1,0,1
2022,ZMB,Perak,2,0,2
2022,ZMB,Perlis,0,0,0
2022,ZMB,Pulau Pinang,4,2,2
2022,ZMB,Sabah,2,2,0
2022,ZMB,Sarawak,4,2,2
2022,ZMB,Selangor,398,230,168
2022,ZWE,Johor,82,34,48
2022,ZWE,Kedah,6,3,3
2022,ZWE,Kelantan,1,0,1
2022,ZWE,Perak,0,0,0
2022,ZWE,Perlis,1,0,1
2022,ZWE,Pulau Pinang,13,4,9
2022,ZWE,Sabah,3,1,2
2022,ZWE,Sarawak,7,3,4
2022,ZWE,Selangor,924,417,507
2023,ABW,Kedah,0,0,0
2023,ABW,Pulau Pinang,0,0,0
2023,AFG,Johor,12,12,0
2023,AFG,Kedah,4,4,0
2023,AFG,Perlis,4,4,0
2023,AFG,Pulau Pinang,2,1,1
2023,AFG,Sarawak,5,5,0
2023,AFG,Selangor,657,488,169
2023,AGO,Johor,5,2,3
2023,AGO,Kedah,2,2,0
2023,AGO,Sabah,0,0,0
2023,AGO,Selangor,71,56,15
2023,AIA,Selangor,1,1,0
2023,ALB,Johor,203,162,41
2023,ALB,Kedah,18,11,7
2023,ALB,Perak,1,1,0
2023,ALB,Perlis,2,1,1
2023,ALB,Pulau Pinang,9,5,4
2023,ALB,Sabah,3,1,2
2023,ALB,Sarawak,4,4,0
2023,ALB,Selangor,387,237,150
2023,AND,Johor,8,3,5
2023,AND,Kedah,2,0,2
2023,AND,Perlis,0,0,0
2023,AND,Pulau Pinang,9,6,3
2023,AND,Selangor,69,38,31
2023,ANT,Selangor,0,0,0
2023,ARE,Johor,352,206,146
2023,ARE,Kedah,140,105,35
2023,ARE,Kelantan,2,2,0
2023,ARE,Perak,0,0,0
2023,ARE,Perlis,9,7,2
2023,ARE,Pulau Pinang,41,22,19
2023,ARE,Sabah,1,1,0
2023,ARE,Sarawak,3,3,0
2023,ARE,Selangor,7927,4454,3473
2023,ARG,Johor,916,553,363
2023,ARG,Kedah,579,276,303
2023,ARG,Kelantan,7,3,4
2023,ARG,Melaka,4,3,1
2023,ARG,Perak,7,5,2
2023,ARG,Perlis,53,26,27
2023,ARG,Pulau Pinang,103,56,47
2023,ARG,Sabah,17,11,6
2023,ARG,Sarawak,21,18,3
2023,ARG,Selangor,4452,2393,2059
2023,ARG,W.P. Labuan,3,1,2
2023,ARM,Johor,72,25,47
2023,ARM,Kedah,23,9,14
2023,ARM,Kelantan,1,1,0
2023,ARM,Perak,0,0,0
2023,ARM,Perlis,1,1,0
2023,ARM,Pulau Pinang,26,8,18
2023,ARM,Sabah,5,3,2
2023,ARM,Sarawak,2,2,0
2023,ARM,Selangor,969,411,558
2023,ATA,Selangor,2,1,1
2023,ATG,Johor,75,55,20
2023,ATG,Kedah,5,2,3
2023,ATG,Pulau Pinang,2,0,2
2023,ATG,Sabah,1,0,1
2023,ATG,Sarawak,1,1,0
2023,ATG,Selangor,192,128,64
2023,AUS,Johor,64433,37344,27089
2023,AUS,Kedah,7713,4178,3535
2023,AUS,Kelantan,107,76,31
2023,AUS,Melaka,22,15,7
2023,AUS,Negeri Sembilan,12,12,0
2023,AUS,Pahang,244,140,104
2023,AUS,Perak,2799,1463,1336
2023,AUS,Perlis,1137,723,414
2023,AUS,Pulau Pinang,24370,12993,11377
2023,AUS,Sabah,4042,2084,1958
2023,AUS,Sarawak,7285,4044,3241
2023,AUS,Selangor,296808,169595,127213
2023,AUS,Terengganu,5,4,1
2023,AUS,W.P. Labuan,119,83,36
2023,AUT,Johor,2149,1400,749
2023,AUT,Kedah,943,500,443
2023,AUT,Kelantan,42,35,7
2023,AUT,Melaka,5,4,1
2023,AUT,Negeri Sembilan,2,1,1
2023,AUT,Pahang,2,2,0
2023,AUT,Perak,23,18,5
2023,AUT,Perlis,158,97,61
2023,AUT,Pulau Pinang,946,646,300
2023,AUT,Sabah,106,65,41
2023,AUT,Sarawak,213,127,86
2023,AUT,Selangor,9762,5929,3833
2023,AUT,Terengganu,0,0,0
2023,AUT,W.P. Labuan,7,7,0
2023,AZE,Johor,67,40,27
2023,AZE,Kedah,32,20,12
2023,AZE,Kelantan,2,2,0
2023,AZE,Melaka,0,0,0
2023,AZE,Perlis,1,1,0
2023,AZE,Pulau Pinang,11,6,5
2023,AZE,Sabah,1,1,0
2023,AZE,Sarawak,25,10,15
2023,AZE,Selangor,1558,843,715
2023,AZE,W.P. Labuan,15,15,0
2023,BDI,Pulau Pinang,2,0,2
2023,BDI,Sarawak,1,1,0
2023,BDI,Selangor,79,31,48
2023,BEL,Johor,3253,2004,1249
2023,BEL,Kedah,1016,538,478
2023,BEL,Kelantan,26,19,7
2023,BEL,Melaka,6,3,3
2023,BEL,Negeri Sembilan,1,0,1
2023,BEL,Pahang,15,10,5
2023,BEL,Perak,38,17,21
2023,BEL,Perlis,211,126,85
2023,BEL,Pulau Pinang,755,521,234
2023,BEL,Sabah,188,112,76
2023,BEL,Sarawak,301,165,136
2023,BEL,Selangor,15199,9010,6189
2023,BEL,W.P. Labuan,11,7,4
2023,BEN,Johor,12,11,1
2023,BEN,Kedah,5,1,4
2023,BEN,Perak,1,1,0
2023,BEN,Pulau Pinang,1,1,0
2023,BEN,Sabah,3,3,0
2023,BEN,Sarawak,3,2,1
2023,BEN,Selangor,134,95,39
2023,BFA,Johor,2,2,0
2023,BFA,Perak,0,0,0
2023,BFA,Pulau Pinang,3,3,0
2023,BFA,Selangor,87,77,10
2023,BGD,Johor,40640,34406,6234
2023,BGD,Kedah,1066,639,427
2023,BGD,Kelantan,24,24,0
2023,BGD,Melaka,1,1,0
2023,BGD,Negeri Sembilan,0,0,0
2023,BGD,Pahang,7,5,2
2023,BGD,Perak,55,43,12
2023,BGD,Perlis,46,41,5
2023,BGD,Pulau Pinang,5770,5502,268
2023,BGD,Sabah,46,32,14
2023,BGD,Sarawak,565,451,114
2023,BGD,Selangor,587217,565144,22073
2023,BGD,W.P. Labuan,108,102,6
2023,BGR,Johor,488,274,214
2023,BGR,Kedah,147,79,68
2023,BGR,Kelantan,4,2,2
2023,BGR,Pahang,0,0,0
2023,BGR,Perak,4,1,3
2023,BGR,Perlis,16,11,5
2023,BGR,Pulau Pinang,115,75,40
2023,BGR,Sabah,32,16,16
2023,BGR,Sarawak,21,16,5
2023,BGR,Selangor,2802,1497,1305
2023,BGR,W.P. Labuan,1,0,1
2023,BHR,Johor,223,107,116
2023,BHR,Kedah,26,15,11
2023,BHR,Kelantan,3,2,1
2023,BHR,Perlis,9,9,0
2023,BHR,Pulau Pinang,30,19,11
2023,BHR,Sabah,0,0,0
2023,BHR,Sarawak,5,4,1
2023,BHR,Selangor,2484,1364,1120
2023,BHS,Johor,13,7,6
2023,BHS,Kedah,5,3,2
2023,BHS,Perak,0,0,0
2023,BHS,Sabah,0,0,0
2023,BHS,Sarawak,0,0,0
2023,BHS,Selangor,101,56,45
2023,BIH,Johor,110,61,49
2023,BIH,Kedah,11,6,5
2023,BIH,Perlis,3,3,0
2023,BIH,Pulau Pinang,16,11,5
2023,BIH,Sabah,5,2,3
2023,BIH,Sarawak,13,13,0
2023,BIH,Selangor,646,378,268
2023,BLR,Johor,188,67,121
2023,BLR,Kedah,165,81,84
2023,BLR,Kelantan,24,14,10
2023,BLR,Pahang,0,0,0
2023,BLR,Perak,1,0,1
2023,BLR,Perlis,21,11,10
2023,BLR,Pulau Pinang,89,42,47
2023,BLR,Sabah,23,8,15
2023,BLR,Sarawak,32,11,21
2023,BLR,Selangor,4573,2164,2409
2023,BLR,W.P. Labuan,0,0,0
2023,BLZ,Johor,39,14,25
2023,BLZ,Pulau Pinang,4,3,1
2023,BLZ,Sarawak,1,1,0
2023,BLZ,Selangor,96,55,41
2023,BMU,Selangor,1,0,1
2023,BOL,Johor,46,28,18
2023,BOL,Kedah,7,1,6
2023,BOL,Melaka,2,2,0
2023,BOL,Perak,0,0,0
2023,BOL,Perlis,1,1,0
2023,BOL,Pulau Pinang,8,3,5
2023,BOL,Sabah,4,3,1
2023,BOL,Sarawak,8,4,4
2023,BOL,Selangor,547,300,247
2023,BRA,Johor,3063,1773,1290
2023,BRA,Kedah,805,391,414
2023,BRA,Kelantan,8,6,2
2023,BRA,Melaka,9,7,2
2023,BRA,Pahang,9,6,3
2023,BRA,Perak,38,23,15
2023,BRA,Perlis,83,42,41
2023,BRA,Pulau Pinang,323,193,130
2023,BRA,Sabah,103,61,42
2023,BRA,Sarawak,112,70,42
2023,BRA,Selangor,10581,6018,4563
2023,BRA,W.P. Labuan,5,4,1
2023,BRB,Johor,19,7,12
2023,BRB,Kedah,1,1,0
2023,BRB,Perlis,0,0,0
2023,BRB,Pulau Pinang,2,0,2
2023,BRB,Selangor,67,37,30
2023,BRN,Johor,6779,3508,3271
2023,BRN,Kedah,399,198,201
2023,BRN,Kelantan,132,74,58
2023,BRN,Melaka,20,11,9
2023,BRN,Pahang,1,1,0
2023,BRN,Perak,47,29,18
2023,BRN,Perlis,364,183,181
2023,BRN,Pulau Pinang,212,100,112
2023,BRN,Sabah,9525,4113,5412
2023,BRN,Sarawak,1016382,558877,457505
2023,BRN,Selangor,63227,31054,32173
2023,BRN,W.P. Labuan,16137,10517,5620
2023,BTN,Johor,127,89,38
2023,BTN,Kedah,4,4,0
2023,BTN,Perak,1,1,0
2023,BTN,Perlis,5,2,3
2023,BTN,Pulau Pinang,22,19,3
2023,BTN,Sabah,2,2,0
2023,BTN,Sarawak,2,2,0
2023,BTN,Selangor,510,337,173
2023,BVT,Selangor,1,0,1
2023,BWA,Johor,21,13,8
2023,BWA,Kedah,6,4,2
2023,BWA,Perlis,1,1,0
2023,BWA,Pulau Pinang,1,1,0
2023,BWA,Sabah,0,0,0
2023,BWA,Sarawak,2,2,0
2023,BWA,Selangor,199,71,128
2023,CAF,Kedah,1,0,1
2023,CAF,Selangor,7,4,3
2023,CAN,Johor,17349,9725,7624
2023,CAN,Kedah,2585,1395,1190
2023,CAN,Kelantan,47,32,15
2023,CAN,Melaka,10,6,4
2023,CAN,Negeri Sembilan,1,1,0
2023,CAN,Pahang,32,23,9
2023,CAN,Perak,484,257,227
2023,CAN,Perlis,598,355,243
2023,CAN,Pulau Pinang,6268,3410,2858
2023,CAN,Sabah,1511,772,739
2023,CAN,Sarawak,3929,2152,1777
2023,CAN,Selangor,51883,29718,22165
2023,CAN,Terengganu,5,5,0
2023,CAN,W.P. Labuan,66,45,21
2023,CCK,Selangor,0,0,0
2023,CHE,Johor,4940,2881,2059
2023,CHE,Kedah,1872,989,883
2023,CHE,Kelantan,34,24,10
2023,CHE,Melaka,6,2,4
2023,CHE,Negeri Sembilan,5,2,3
2023,CHE,Pahang,35,22,13
2023,CHE,Perak,63,42,21
2023,CHE,Perlis,376,221,155
2023,CHE,Pulau Pinang,1612,1001,611
2023,CHE,Sabah,344,189,155
2023,CHE,Sarawak,461,231,230
2023,CHE,Selangor,16830,9978,6852
2023,CHE,W.P. Labuan,15,10,5
2023,CHL,Johor,366,195,171
2023,CHL,Kedah,190,95,95
2023,CHL,Kelantan,7,4,3
2023,CHL,Melaka,0,0,0
2023,CHL,Pahang,4,1,3
2023,CHL,Perak,1,1,0
2023,CHL,Perlis,53,34,19
2023,CHL,Pulau Pinang,81,47,34
2023,CHL,Sabah,26,11,15
2023,CHL,Sarawak,17,13,4
2023,CHL,Selangor,2765,1403,1362
2023,CHN,Johor,492265,213854,278411
2023,CHN,Kedah,13060,5733,7327
2023,CHN,Kelantan,107,60,47
2023,CHN,Melaka,25,19,6
2023,CHN,Negeri Sembilan,5,4,1
2023,CHN,Pahang,396,210,186
2023,CHN,Perak,2838,1246,1592
2023,CHN,Perlis,1456,704,752
2023,CHN,Pulau Pinang,88726,46840,41886
2023,CHN,Sabah,66427,31561,34866
2023,CHN,Sarawak,11088,5546,5542
2023,CHN,Selangor,984675,504448,480227
2023,CHN,Terengganu,1,1,0
2023,CHN,W.P. Labuan,650,563,87
2023,CIV,Johor,17,12,5
2023,CIV,Kedah,0,0,0
2023,CIV,Pulau Pinang,2,0,2
2023,CIV,Sabah,0,0,0
2023,CIV,Sarawak,0,0,0
2023,CIV,Selangor,287,208,79
2023,CMR,Johor,15,15,0
2023,CMR,Kedah,8,5,3
2023,CMR,Pulau Pinang,7,5,2
2023,CMR,Sabah,3,3,0
2023,CMR,Sarawak,1,1,0
2023,CMR,Selangor,326,228,98
2023,COD,Johor,22,22,0
2023,COD,Pulau Pinang,0,0,0
2023,COD,Sarawak,2,1,1
2023,COD,Selangor,147,102,45
2023,COG,Johor,0,0,0
2023,COG,Kedah,0,0,0
2023,COG,Selangor,55,39,16
2023,COK,Selangor,1,1,0
2023,COL,Johor,346,178,168
2023,COL,Kedah,33,14,19
2023,COL,Perak,2,1,1
2023,COL,Perlis,1,1,0
2023,COL,Pulau Pinang,53,24,29
2023,COL,Sabah,13,4,9
2023,COL,Sarawak,25,18,7
2023,COL,Selangor,2385,1255,1130
2023,COL,W.P. Labuan,1,1,0
2023,COM,Johor,19,6,13
2023,COM,Kedah,2,2,0
2023,COM,Selangor,228,135,93
2023,CPV,Johor,3,0,3
2023,CPV,Kedah,2,2,0
2023,CPV,Pulau Pinang,0,0,0
2023,CPV,Sabah,1,1,0
2023,CPV,Selangor,26,12,14
2023,CRI,Johor,163,97,66
2023,CRI,Kedah,13,6,7
2023,CRI,Perak,0,0,0
2023,CRI,Perlis,0,0,0
2023,CRI,Pulau Pinang,75,51,24
2023,CRI,Sabah,12,9,3
2023,CRI,Sarawak,5,5,0
2023,CRI,Selangor,654,372,282
2023,CUB,Johor,51,36,15
2023,CUB,Kedah,3,1,2
2023,CUB,Perlis,0,0,0
2023,CUB,Pulau Pinang,6,4,2
2023,CUB,Sabah,3,2,1
2023,CUB,Sarawak,0,0,0
2023,CUB,Selangor,270,146,124
2023,CYP,Johor,133,79,54
2023,CYP,Kedah,24,12,12
2023,CYP,Perak,0,0,0
2023,CYP,Perlis,3,2,1
2023,CYP,Pulau Pinang,21,14,7
2023,CYP,Sabah,9,4,5
2023,CYP,Sarawak,12,3,9
2023,CYP,Selangor,904,579,325
2023,CZE,Johor,1365,779,586
2023,CZE,Kedah,988,506,482
2023,CZE,Kelantan,19,10,9
2023,CZE,Melaka,0,0,0
2023,CZE,Negeri Sembilan,0,0,0
2023,CZE,Perak,12,7,5
2023,CZE,Perlis,73,44,29
2023,CZE,Pulau Pinang,256,149,107
2023,CZE,Sabah,144,89,55
2023,CZE,Sarawak,164,93,71
2023,CZE,Selangor,6672,3866,2806
2023,CZE,W.P. Labuan,35,17,18
2023,DEU,Johor,27672,16968,10704
2023,DEU,Kedah,10391,5365,5026
2023,DEU,Kelantan,161,111,50
2023,DEU,Melaka,50,31,19
2023,DEU,Negeri Sembilan,9,6,3
2023,DEU,Pahang,103,66,37
2023,DEU,Perak,370,237,133
2023,DEU,Perlis,1592,956,636
2023,DEU,Pulau Pinang,8634,5930,2704
2023,DEU,Sabah,1318,792,526
2023,DEU,Sarawak,2650,1553,1097
2023,DEU,Selangor,91661,54821,36840
2023,DEU,Terengganu,1,1,0
2023,DEU,W.P. Labuan,105,67,38
2023,DJI,Johor,3,3,0
2023,DJI,Selangor,139,80,59
2023,DMA,Johor,82,70,12
2023,DMA,Kedah,2,2,0
2023,DMA,Pulau Pinang,7,6,1
2023,DMA,Sabah,1,0,1
2023,DMA,Sarawak,7,4,3
2023,DMA,Selangor,506,389,117
2023,DMA,W.P. Labuan,0,0,0
2023,DNK,Johor,3453,2414,1039
2023,DNK,Kedah,1466,735,731
2023,DNK,Kelantan,17,14,3
2023,DNK,Melaka,8,5,3
2023,DNK,Negeri Sembilan,7,5,2
2023,DNK,Pahang,6,4,2
2023,DNK,Perak,41,22,19
2023,DNK,Perlis,170,114,56
2023,DNK,Pulau Pinang,731,492,239
2023,DNK,Sabah,362,185,177
2023,DNK,Sarawak,231,128,103
2023,DNK,Selangor,12579,7377,5202
2023,DNK,W.P. Labuan,9,2,7
2023,DOM,Johor,27,13,14
2023,DOM,Kedah,3,0,3
2023,DOM,Perak,0,0,0
2023,DOM,Perlis,0,0,0
2023,DOM,Pulau Pinang,17,6,11
2023,DOM,Sabah,4,1,3
2023,DOM,Sarawak,1,0,1
2023,DOM,Selangor,341,183,158
2023,DZA,Johor,438,278,160
2023,DZA,Kedah,42,36,6
2023,DZA,Kelantan,2,2,0
2023,DZA,Melaka,0,0,0
2023,DZA,Perak,3,2,1
2023,DZA,Perlis,14,11,3
2023,DZA,Pulau Pinang,24,16,8
2023,DZA,Sabah,15,9,6
2023,DZA,Sarawak,51,46,5
2023,DZA,Selangor,11224,6702,4522
2023,DZA,W.P. Labuan,1,1,0
2023,ECU,Johor,143,74,69
2023,ECU,Kedah,16,4,12
2023,ECU,Perak,0,0,0
2023,ECU,Perlis,4,1,3
2023,ECU,Pulau Pinang,24,9,15
2023,ECU,Sabah,7,4,3
2023,ECU,Sarawak,0,0,0
2023,ECU,Selangor,846,424,422
2023,EGY,Johor,2564,2077,487
2023,EGY,Kedah,86,58,28
2023,EGY,Kelantan,15,9,6
2023,EGY,Melaka,6,6,0
2023,EGY,Pahang,2,2,0
2023,EGY,Perak,7,4,3
2023,EGY,Perlis,17,11,6
2023,EGY,Pulau Pinang,127,101,26
2023,EGY,Sabah,47,40,7
2023,EGY,Sarawak,1381,934,447
2023,EGY,Selangor,21409,14497,6912
2023,EGY,Terengganu,2,2,0
2023,EGY,W.P. Labuan,6,5,1
2023,ERI,Johor,6,2,4
2023,ERI,Pulau Pinang,2,1,1
2023,ERI,Sabah,0,0,0
2023,ERI,Selangor,209,117,92
2023,ESP,Johor,6644,3946,2698
2023,ESP,Kedah,1989,1021,968
2023,ESP,Kelantan,67,40,27
2023,ESP,Melaka,6,5,1
2023,ESP,Negeri Sembilan,3,3,0
2023,ESP,Pahang,8,5,3
2023,ESP,Perak,73,38,35
2023,ESP,Perlis,258,166,92
2023,ESP,Pulau Pinang,1502,835,667
2023,ESP,Sabah,373,215,158
2023,ESP,Sarawak,676,423,253
2023,ESP,Selangor,37236,20413,16823
2023,ESP,W.P. Labuan,37,20,17
2023,EST,Johor,399,218,181
2023,EST,Kedah,382,195,187
2023,EST,Kelantan,7,2,5
2023,EST,Pahang,1,1,0
2023,EST,Perak,0,0,0
2023,EST,Perlis,30,13,17
2023,EST,Pulau Pinang,120,66,54
2023,EST,Sabah,35,17,18
2023,EST,Sarawak,65,32,33
2023,EST,Selangor,2283,1201,1082
2023,EST,W.P. Labuan,9,2,7
2023,ETH,Johor,24,15,9
2023,ETH,Kedah,1,0,1
2023,ETH,Pulau Pinang,3,2,1
2023,ETH,Sabah,1,0,1
2023,ETH,Sarawak,1,1,0
2023,ETH,Selangor,442,273,169
2023,FIN,Johor,1981,1201,780
2023,FIN,Kedah,929,469,460
2023,FIN,Kelantan,13,7,6
2023,FIN,Melaka,3,3,0
2023,FIN,Negeri Sembilan,3,3,0
2023,FIN,Pahang,0,0,0
2023,FIN,Perak,45,28,17
2023,FIN,Perlis,105,77,28
2023,FIN,Pulau Pinang,544,337,207
2023,FIN,Sabah,155,83,72
2023,FIN,Sarawak,149,85,64
2023,FIN,Selangor,6208,3548,2660
2023,FIN,W.P. Labuan,11,8,3
2023,FJI,Johor,943,481,462
2023,FJI,Kedah,20,9,11
2023,FJI,Kelantan,1,1,0
2023,FJI,Perak,2,2,0
2023,FJI,Perlis,3,2,1
2023,FJI,Pulau Pinang,40,22,18
2023,FJI,Sabah,10,5,5
2023,FJI,Sarawak,17,8,9
2023,FJI,Selangor,1643,848,795
2023,FRA,Johor,25371,15168,10203
2023,FRA,Kedah,6661,3620,3041
2023,FRA,Kelantan,251,157,94
2023,FRA,Melaka,48,27,21
2023,FRA,Negeri Sembilan,25,14,11
2023,FRA,Pahang,200,114,86
2023,FRA,Perak,380,243,137
2023,FRA,Perlis,1071,704,367
2023,FRA,Pulau Pinang,4872,3047,1825
2023,FRA,Sabah,1171,710,461
2023,FRA,Sarawak,1462,915,547
2023,FRA,Selangor,100282,58035,42247
2023,FRA,Terengganu,1,1,0
2023,FRA,W.P. Labuan,33,22,11
2023,FSM,Johor,0,0,0
2023,FSM,Pulau Pinang,0,0,0
2023,FSM,Selangor,15,7,8
2023,GAB,Johor,12,5,7
2023,GAB,Pulau Pinang,1,1,0
2023,GAB,Sarawak,1,0,1
2023,GAB,Selangor,120,81,39
2023,GBR,Johor,56633,35820,20813
2023,GBR,Kedah,16399,8767,7632
2023,GBR,Kelantan,194,145,49
2023,GBR,Melaka,32,21,11
2023,GBR,Negeri Sembilan,7,7,0
2023,GBR,Pahang,234,155,79
2023,GBR,Perak,1262,732,530
2023,GBR,Perlis,2161,1357,804
2023,GBR,Pulau Pinang,18734,11000,7734
2023,GBR,Sabah,5180,2810,2370
2023,GBR,Sarawak,13615,8244,5371
2023,GBR,Selangor,210746,125840,84906
2023,GBR,Terengganu,0,0,0
2023,GBR,W.P. Labuan,456,333,123
2023,GEO,Johor,76,60,16
2023,GEO,Kedah,27,15,12
2023,GEO,Melaka,0,0,0
2023,GEO,Perak,0,0,0
2023,GEO,Perlis,10,6,4
2023,GEO,Pulau Pinang,18,6,12
2023,GEO,Sabah,5,4,1
2023,GEO,Sarawak,1,0,1
2023,GEO,Selangor,667,408,259
2023,GHA,Johor,99,85,14
2023,GHA,Kedah,13,7,6
2023,GHA,Kelantan,1,1,0
2023,GHA,Perlis,2,1,1
2023,GHA,Pulau Pinang,16,8,8
2023,GHA,Sabah,5,3,2
2023,GHA,Sarawak,8,4,4
2023,GHA,Selangor,946,648,298
2023,GIB,Johor,1,0,1
2023,GIB,Sarawak,0,0,0
2023,GIN,Johor,72,50,22
2023,GIN,Kedah,9,8,1
2023,GIN,Kelantan,3,3,0
2023,GIN,Perlis,2,1,1
2023,GIN,Pulau Pinang,1,1,0
2023,GIN,Sabah,2,1,1
2023,GIN,Sarawak,2,2,0
2023,GIN,Selangor,629,457,172
2023,GLP,Selangor,0,0,0
2023,GMB,Johor,36,30,6
2023,GMB,Kedah,0,0,0
2023,GMB,Kelantan,0,0,0
2023,GMB,Pulau Pinang,1,1,0
2023,GMB,Sabah,4,4,0
2023,GMB,Sarawak,2,2,0
2023,GMB,Selangor,273,200,73
2023,GNB,Johor,4,4,0
2023,GNB,Selangor,5,4,1
2023,GNQ,Johor,2,2,0
2023,GNQ,Selangor,17,7,10
2023,GRC,Johor,684,509,175
2023,GRC,Kedah,175,97,78
2023,GRC,Kelantan,6,4,2
2023,GRC,Melaka,0,0,0
2023,GRC,Negeri Sembilan,3,3,0
2023,GRC,Pahang,4,4,0
2023,GRC,Perak,3,2,1
2023,GRC,Perlis,30,21,9
2023,GRC,Pulau Pinang,117,83,34
2023,GRC,Sabah,47,31,16
2023,GRC,Sarawak,86,48,38
2023,GRC,Selangor,3088,2162,926
2023,GRD,Johor,80,37,43
2023,GRD,Kedah,8,2,6
2023,GRD,Pulau Pinang,5,4,1
2023,GRD,Sabah,1,1,0
2023,GRD,Sarawak,0,0,0
2023,GRD,Selangor,133,105,28
2023,GRL,Johor,1,1,0
2023,GRL,Selangor,1,0,1
2023,GTM,Johor,42,23,19
2023,GTM,Kedah,7,3,4
2023,GTM,Pahang,0,0,0
2023,GTM,Perak,0,0,0
2023,GTM,Pulau Pinang,14,11,3
2023,GTM,Sabah,1,0,1
2023,GTM,Sarawak,1,0,1
2023,GTM,Selangor,410,220,190
2023,GTM,W.P. Labuan,1,0,1
2023,GUY,Johor,14,6,8
2023,GUY,Kedah,0,0,0
2023,GUY,Pulau Pinang,2,1,1
2023,GUY,Sarawak,1,0,1
2023,GUY,Selangor,74,42,32
2023,HKG,Johor,64,34,30
2023,HKG,Kedah,9,6,3
2023,HKG,Kelantan,1,1,0
2023,HKG,Pahang,29,14,15
2023,HKG,Perak,559,250,309
2023,HKG,Perlis,27,18,9
2023,HKG,Pulau Pinang,1,0,1
2023,HKG,Sabah,6719,2961,3758
2023,HKG,Sarawak,2,1,1
2023,HKG,Selangor,2933,1559,1374
2023,HKG,Terengganu,1,1,0
2023,HMD,Johor,1,0,1
2023,HND,Johor,51,35,16
2023,HND,Kedah,5,5,0
2023,HND,Perak,0,0,0
2023,HND,Pulau Pinang,5,1,4
2023,HND,Sabah,2,0,2
2023,HND,Sarawak,2,0,2
2023,HND,Selangor,201,124,77
2023,HRV,Johor,522,393,129
2023,HRV,Kedah,58,31,27
2023,HRV,Kelantan,7,7,0
2023,HRV,Melaka,1,1,0
2023,HRV,Pahang,3,3,0
2023,HRV,Perak,0,0,0
2023,HRV,Perlis,1,1,0
2023,HRV,Pulau Pinang,64,43,21
2023,HRV,Sabah,23,15,8
2023,HRV,Sarawak,29,24,5
2023,HRV,Selangor,2095,1309,786
2023,HTI,Johor,17,14,3
2023,HTI,Kedah,0,0,0
2023,HTI,Kelantan,1,1,0
2023,HTI,Perak,0,0,0
2023,HTI,Pulau Pinang,0,0,0
2023,HTI,Sabah,1,1,0
2023,HTI,Selangor,72,50,22
2023,HUN,Johor,1060,651,409
2023,HUN,Kedah,380,193,187
2023,HUN,Kelantan,3,1,2
2023,HUN,Pahang,0,0,0
2023,HUN,Perak,14,11,3
2023,HUN,Perlis,42,21,21
2023,HUN,Pulau Pinang,299,181,118
2023,HUN,Sabah,56,33,23
2023,HUN,Sarawak,110,54,56
2023,HUN,Selangor,6052,3244,2808
2023,HUN,W.P. Labuan,0,0,0
2023,IDN,Johor,1189864,575787,614077
2023,IDN,Kedah,62635,23223,39412
2023,IDN,Kelantan,1817,1070,747
2023,IDN,Melaka,56036,25077,30959
2023,IDN,Negeri Sembilan,85464,55389,30075
2023,IDN,Pahang,271,172,99
2023,IDN,Perak,2789,993,1796
2023,IDN,Perlis,6952,2792,4160
2023,IDN,Pulau Pinang,450188,178575,271613
2023,IDN,Sabah,59313,28839,30474
2023,IDN,Sarawak,464315,242680,221635
2023,IDN,Selangor,1354439,643236,711203
2023,IDN,Terengganu,8,8,0
2023,IDN,W.P. Labuan,730,399,331
2023,IND,Johor,284215,191138,93077
2023,IND,Kedah,13844,7467,6377
2023,IND,Kelantan,48,42,6
2023,IND,Melaka,29,27,2
2023,IND,Negeri Sembilan,4,4,0
2023,IND,Pahang,125,97,28
2023,IND,Perak,3848,2939,909
2023,IND,Perlis,475,372,103
2023,IND,Pulau Pinang,14090,9998,4092
2023,IND,Sabah,2250,1567,683
2023,IND,Sarawak,15511,12262,3249
2023,IND,Selangor,595266,412518,182748
2023,IND,Terengganu,0,0,0
2023,IND,W.P. Labuan,843,680,163
2023,IOT,Pulau Pinang,2,0,2
2023,IOT,Selangor,3,0,3
2023,IRL,Johor,3222,2027,1195
2023,IRL,Kedah,1012,550,462
2023,IRL,Kelantan,15,12,3
2023,IRL,Negeri Sembilan,1,0,1
2023,IRL,Pahang,10,4,6
2023,IRL,Perak,95,58,37
2023,IRL,Perlis,187,122,65
2023,IRL,Pulau Pinang,1300,791,509
2023,IRL,Sabah,209,122,87
2023,IRL,Sarawak,487,247,240
2023,IRL,Selangor,15831,9373,6458
2023,IRL,Terengganu,2,2,0
2023,IRL,W.P. Labuan,12,6,6
2023,IRN,Johor,2792,1540,1252
2023,IRN,Kedah,141,78,63
2023,IRN,Kelantan,2,1,1
2023,IRN,Perak,1,1,0
2023,IRN,Perlis,66,44,22
2023,IRN,Pulau Pinang,93,49,44
2023,IRN,Sabah,16,8,8
2023,IRN,Sarawak,66,42,24
2023,IRN,Selangor,20820,11100,9720
2023,IRN,W.P. Labuan,0,0,0
2023,IRQ,Johor,442,306,136
2023,IRQ,Kedah,20,13,7
2023,IRQ,Kelantan,1,1,0
2023,IRQ,Melaka,0,0,0
2023,IRQ,Pahang,1,1,0
2023,IRQ,Perak,1,0,1
2023,IRQ,Perlis,1,1,0
2023,IRQ,Pulau Pinang,30,24,6
2023,IRQ,Sabah,3,2,1
2023,IRQ,Sarawak,23,12,11
2023,IRQ,Selangor,13292,8878,4414
2023,ISL,Johor,88,50,38
2023,ISL,Kedah,25,13,12
2023,ISL,Kelantan,0,0,0
2023,ISL,Perak,17,9,8
2023,ISL,Perlis,4,2,2
2023,ISL,Pulau Pinang,20,11,9
2023,ISL,Sabah,23,15,8
2023,ISL,Sarawak,11,7,4
2023,ISL,Selangor,382,201,181
2023,ISL,W.P. Labuan,0,0,0
2023,ISR,Pulau Pinang,2,1,1
2023,ITA,Johor,8526,5487,3039
2023,ITA,Kedah,2930,1653,1277
2023,ITA,Kelantan,47,38,9
2023,ITA,Melaka,6,3,3
2023,ITA,Negeri Sembilan,2,2,0
2023,ITA,Pahang,18,13,5
2023,ITA,Perak,77,49,28
2023,ITA,Perlis,332,236,96
2023,ITA,Pulau Pinang,1605,1143,462
2023,ITA,Sabah,385,230,155
2023,ITA,Sarawak,1033,615,418
2023,ITA,Selangor,43145,26554,16591
2023,ITA,W.P. Labuan,31,22,9
2023,JAM,Johor,36,10,26
2023,JAM,Kedah,9,4,5
2023,JAM,Perak,0,0,0
2023,JAM,Pulau Pinang,17,8,9
2023,JAM,Sabah,0,0,0
2023,JAM,Sarawak,4,3,1
2023,JAM,Selangor,236,87,149
2023,JAM,W.P. Labuan,3,1,2
2023,JOR,Johor,207,137,70
2023,JOR,Kedah,64,35,29
2023,JOR,Kelantan,3,2,1
2023,JOR,Melaka,1,1,0
2023,JOR,Pahang,1,1,0
2023,JOR,Perak,1,1,0
2023,JOR,Perlis,11,9,2
2023,JOR,Pulau Pinang,104,66,38
2023,JOR,Sabah,15,11,4
2023,JOR,Sarawak,11,7,4
2023,JOR,Selangor,10142,6123,4019
2023,JOR,W.P. Labuan,0,0,0
2023,JPN,Johor,72785,48131,24654
2023,JPN,Kedah,3665,1878,1787
2023,JPN,Kelantan,129,92,37
2023,JPN,Melaka,18,17,1
2023,JPN,Negeri Sembilan,1,1,0
2023,JPN,Pahang,125,84,41
2023,JPN,Perak,735,483,252
2023,JPN,Perlis,908,713,195
2023,JPN,Pulau Pinang,15836,10919,4917
2023,JPN,Sabah,3382,1771,1611
2023,JPN,Sarawak,2395,1482,913
2023,JPN,Selangor,223920,136917,87003
2023,JPN,W.P. Labuan,151,95,56
2023,KAZ,Johor,674,301,373
2023,KAZ,Kedah,191,87,104
2023,KAZ,Kelantan,24,7,17
2023,KAZ,Melaka,0,0,0
2023,KAZ,Perak,1,1,0
2023,KAZ,Perlis,58,24,34
2023,KAZ,Pulau Pinang,100,45,55
2023,KAZ,Sabah,38,14,24
2023,KAZ,Sarawak,55,12,43
2023,KAZ,Selangor,9104,3806,5298
2023,KAZ,W.P. Labuan,3,0,3
2023,KEN,Johor,974,452,522
2023,KEN,Kedah,48,22,26
2023,KEN,Kelantan,0,0,0
2023,KEN,Perak,0,0,0
2023,KEN,Perlis,6,2,4
2023,KEN,Pulau Pinang,54,21,33
2023,KEN,Sabah,16,10,6
2023,KEN,Sarawak,25,13,12
2023,KEN,Selangor,5131,2592,2539
2023,KGZ,Johor,332,215,117
2023,KGZ,Kedah,34,24,10
2023,KGZ,Kelantan,4,3,1
2023,KGZ,Perak,1,1,0
2023,KGZ,Perlis,5,0,5
2023,KGZ,Pulau Pinang,36,17,19
2023,KGZ,Sabah,8,4,4
2023,KGZ,Sarawak,2,1,1
2023,KGZ,Selangor,2666,1329,1337
2023,KHM,Johor,29074,12379,16695
2023,KHM,Kedah,2073,1403,670
2023,KHM,Kelantan,7203,4493,2710
2023,KHM,Melaka,5,3,2
2023,KHM,Negeri Sembilan,0,0,0
2023,KHM,Pahang,1,0,1
2023,KHM,Perak,108,29,79
2023,KHM,Perlis,8371,5115,3256
2023,KHM,Pulau Pinang,481,224,257
2023,KHM,Sabah,24,11,13
2023,KHM,Sarawak,112,34,78
2023,KHM,Selangor,49189,23217,25972
2023,KHM,W.P. Labuan,3,0,3
2023,KIR,Johor,5,4,1
2023,KIR,Sabah,0,0,0
2023,KIR,Selangor,14,7,7
2023,KNA,Johor,293,206,87
2023,KNA,Kedah,21,15,6
2023,KNA,Perak,1,0,1
2023,KNA,Perlis,0,0,0
2023,KNA,Pulau Pinang,27,23,4
2023,KNA,Sabah,17,9,8
2023,KNA,Selangor,773,571,202
2023,KNA,W.P. Labuan,1,1,0
2023,KOR,Johor,134253,71749,62504
2023,KOR,Kedah,3077,1601,1476
2023,KOR,Kelantan,33,17,16
2023,KOR,Melaka,40,27,13
2023,KOR,Negeri Sembilan,4,3,1
2023,KOR,Pahang,35,12,23
2023,KOR,Perak,289,149,140
2023,KOR,Perlis,867,588,279
2023,KOR,Pulau Pinang,6479,3622,2857
2023,KOR,Sabah,127029,53668,73361
2023,KOR,Sarawak,2874,1669,1205
2023,KOR,Selangor,169584,92228,77356
2023,KOR,Terengganu,0,0,0
2023,KOR,W.P. Labuan,96,64,32
2023,KWT,Johor,703,370,333
2023,KWT,Kedah,126,58,68
2023,KWT,Kelantan,5,3,2
2023,KWT,Perak,1,0,1
2023,KWT,Perlis,5,4,1
2023,KWT,Pulau Pinang,104,51,53
2023,KWT,Sabah,2,1,1
2023,KWT,Sarawak,10,7,3
2023,KWT,Selangor,11885,6270,5615
2023,KWT,W.P. Labuan,1,1,0
2023,LAO,Johor,2263,691,1572
2023,LAO,Kedah,10137,946,9191
2023,LAO,Kelantan,2915,1121,1794
2023,LAO,Melaka,0,0,0
2023,LAO,Perak,338,44,294
2023,LAO,Perlis,4414,1237,3177
2023,LAO,Pulau Pinang,245,80,165
2023,LAO,Sabah,25,8,17
2023,LAO,Sarawak,153,73,80
2023,LAO,Selangor,3472,1320,2152
2023,LAO,W.P. Labuan,1,0,1
2023,LBN,Johor,221,139,82
2023,LBN,Kedah,39,17,22
2023,LBN,Kelantan,0,0,0
2023,LBN,Pahang,1,0,1
2023,LBN,Perak,2,2,0
2023,LBN,Perlis,0,0,0
2023,LBN,Pulau Pinang,32,24,8
2023,LBN,Sabah,9,7,2
2023,LBN,Sarawak,29,28,1
2023,LBN,Selangor,3183,2011,1172
2023,LBN,W.P. Labuan,0,0,0
2023,LBR,Johor,19,15,4
2023,LBR,Kedah,1,1,0
2023,LBR,Sabah,0,0,0
2023,LBR,Sarawak,2,2,0
2023,LBR,Selangor,86,72,14
2023,LBY,Johor,44,35,9
2023,LBY,Kedah,6,6,0
2023,LBY,Perlis,2,2,0
2023,LBY,Pulau Pinang,17,11,6
2023,LBY,Sabah,5,5,0
2023,LBY,Sarawak,37,25,12
2023,LBY,Selangor,4285,3026,1259
2023,LCA,Johor,88,73,15
2023,LCA,Kedah,2,0,2
2023,LCA,Pulau Pinang,10,7,3
2023,LCA,Sarawak,15,10,5
2023,LCA,Selangor,111,81,30
2023,LIE,Johor,13,10,3
2023,LIE,Kedah,5,1,4
2023,LIE,Perlis,2,2,0
2023,LIE,Pulau Pinang,11,9,2
2023,LIE,Sabah,0,0,0
2023,LIE,Sarawak,1,1,0
2023,LIE,Selangor,65,32,33
2023,LKA,Johor,14337,9265,5072
2023,LKA,Kedah,542,294,248
2023,LKA,Kelantan,8,7,1
2023,LKA,Melaka,3,3,0
2023,LKA,Pahang,1,1,0
2023,LKA,Perak,46,29,17
2023,LKA,Perlis,24,20,4
2023,LKA,Pulau Pinang,477,303,174
2023,LKA,Sabah,92,60,32
2023,LKA,Sarawak,346,234,112
2023,LKA,Selangor,50384,32333,18051
2023,LKA,W.P. Labuan,14,13,1
2023,LSO,Johor,6,4,2
2023,LSO,Kedah,1,0,1
2023,LSO,Pulau Pinang,1,0,1
2023,LSO,Sarawak,1,1,0
2023,LSO,Selangor,53,20,33
2023,LTU,Johor,772,328,444
2023,LTU,Kedah,442,195,247
2023,LTU,Kelantan,7,6,1
2023,LTU,Pahang,1,1,0
2023,LTU,Perak,13,4,9
2023,LTU,Perlis,60,43,17
2023,LTU,Pulau Pinang,106,51,55
2023,LTU,Sabah,38,17,21
2023,LTU,Sarawak,128,52,76
2023,LTU,Selangor,4037,2033,2004
2023,LTU,W.P. Labuan,42,18,24
2023,LUX,Johor,110,76,34
2023,LUX,Kedah,62,35,27
2023,LUX,Kelantan,0,0,0
2023,LUX,Perak,1,1,0
2023,LUX,Perlis,8,5,3
2023,LUX,Pulau Pinang,38,23,15
2023,LUX,Sabah,10,3,7
2023,LUX,Sarawak,4,3,1
2023,LUX,Selangor,617,389,228
2023,LVA,Johor,363,160,203
2023,LVA,Kedah,131,55,76
2023,LVA,Kelantan,4,1,3
2023,LVA,Pahang,2,2,0
2023,LVA,Perak,5,2,3
2023,LVA,Perlis,24,17,7
2023,LVA,Pulau Pinang,35,13,22
2023,LVA,Sabah,22,7,15
2023,LVA,Sarawak,146,52,94
2023,LVA,Selangor,2080,1074,1006
2023,LVA,W.P. Labuan,14,2,12
2023,MAC,Johor,5,3,2
2023,MAC,Pahang,2,1,1
2023,MAC,Perak,23,13,10
2023,MAC,Selangor,53,28,25
2023,MAC,W.P. Labuan,0,0,0
2023,MAR,Johor,1020,638,382
2023,MAR,Kedah,106,69,37
2023,MAR,Kelantan,11,8,3
2023,MAR,Melaka,0,0,0
2023,MAR,Pahang,4,2,2
2023,MAR,Perak,3,2,1
2023,MAR,Perlis,33,30,3
2023,MAR,Pulau Pinang,138,106,32
2023,MAR,Sabah,26,18,8
2023,MAR,Sarawak,80,66,14
2023,MAR,Selangor,12133,6000,6133
2023,MAR,W.P. Labuan,3,3,0
2023,MCO,Johor,3,3,0
2023,MCO,Kedah,3,2,1
2023,MCO,Sabah,1,1,0
2023,MCO,Selangor,27,15,12
2023,MDA,Johor,39,22,17
2023,MDA,Kedah,16,9,7
2023,MDA,Kelantan,1,0,1
2023,MDA,Negeri Sembilan,2,2,0
2023,MDA,Perlis,3,2,1
2023,MDA,Pulau Pinang,10,7,3
2023,MDA,Sabah,1,1,0
2023,MDA,Sarawak,3,0,3
2023,MDA,Selangor,368,208,160
2023,MDG,Johor,148,58,90
2023,MDG,Kedah,15,4,11
2023,MDG,Perak,0,0,0
2023,MDG,Perlis,1,0,1
2023,MDG,Pulau Pinang,11,4,7
2023,MDG,Sabah,3,0,3
2023,MDG,Sarawak,1,0,1
2023,MDG,Selangor,1005,444,561
2023,MDV,Johor,2200,1105,1095
2023,MDV,Kedah,40,25,15
2023,MDV,Kelantan,4,3,1
2023,MDV,Perak,3,2,1
2023,MDV,Perlis,3,3,0
2023,MDV,Pulau Pinang,59,33,26
2023,MDV,Sabah,20,13,7
2023,MDV,Sarawak,22,11,11
2023,MDV,Selangor,30882,16207,14675
2023,MEX,Johor,2069,984,1085
2023,MEX,Kedah,203,86,117
2023,MEX,Kelantan,4,2,2
2023,MEX,Pahang,4,3,1
2023,MEX,Perak,17,10,7
2023,MEX,Perlis,32,16,16
2023,MEX,Pulau Pinang,349,224,125
2023,MEX,Sabah,50,22,28
2023,MEX,Sarawak,69,36,33
2023,MEX,Selangor,7744,3938,3806
2023,MEX,W.P. Labuan,0,0,0
2023,MHL,Johor,11,9,2
2023,MHL,Kedah,0,0,0
2023,MHL,Perak,2,1,1
2023,MHL,Pulau Pinang,2,2,0
2023,MHL,Sabah,1,1,0
2023,MHL,Sarawak,1,1,0
2023,MHL,Selangor,38,28,10
2023,MKD,Johor,54,29,25
2023,MKD,Kedah,31,12,19
2023,MKD,Perak,0,0,0
2023,MKD,Pulau Pinang,6,2,4
2023,MKD,Sabah,2,1,1
2023,MKD,Sarawak,11,3,8
2023,MKD,Selangor,475,262,213
2023,MLI,Johor,25,25,0
2023,MLI,Sabah,0,0,0
2023,MLI,Selangor,133,95,38
2023,MLT,Johor,112,68,44
2023,MLT,Kedah,31,22,9
2023,MLT,Kelantan,1,1,0
2023,MLT,Perak,0,0,0
2023,MLT,Perlis,7,5,2
2023,MLT,Pulau Pinang,68,40,28
2023,MLT,Sabah,5,3,2
2023,MLT,Sarawak,7,6,1
2023,MLT,Selangor,592,357,235
2023,MLT,W.P. Labuan,0,0,0
2023,MMR,Johor,66810,20234,46576
2023,MMR,Kedah,872,191,681
2023,MMR,Kelantan,27,10,17
2023,MMR,Negeri Sembilan,2,2,0
2023,MMR,Pahang,35,8,27
2023,MMR,Perak,315,74,241
2023,MMR,Perlis,65,9,56
2023,MMR,Pulau Pinang,3722,1848,1874
2023,MMR,Sabah,193,62,131
2023,MMR,Sarawak,959,422,537
2023,MMR,Selangor,83681,57836,25845
2023,MMR,Terengganu,1,1,0
2023,MMR,W.P. Labuan,13,7,6
2023,MNE,Johor,30,29,1
2023,MNE,Kedah,1,0,1
2023,MNE,Pulau Pinang,0,0,0
2023,MNE,Sabah,1,1,0
2023,MNE,Sarawak,1,1,0
2023,MNE,Selangor,156,118,38
2023,MNG,Johor,2200,911,1289
2023,MNG,Kedah,110,48,62
2023,MNG,Kelantan,10,4,6
2023,MNG,Perak,6,2,4
2023,MNG,Perlis,73,47,26
2023,MNG,Pulau Pinang,131,53,78
2023,MNG,Sabah,69,23,46
2023,MNG,Sarawak,3,1,2
2023,MNG,Selangor,4432,1832,2600
2023,MNP,Selangor,1,0,1
2023,MOZ,Johor,4,2,2
2023,MOZ,Kedah,3,3,0
2023,MOZ,Perak,0,0,0
2023,MOZ,Pulau Pinang,6,3,3
2023,MOZ,Sabah,0,0,0
2023,MOZ,Sarawak,2,1,1
2023,MOZ,Selangor,322,156,166
2023,MRT,Johor,21,18,3
2023,MRT,Kedah,1,1,0
2023,MRT,Pulau Pinang,1,1,0
2023,MRT,Sabah,0,0,0
2023,MRT,Sarawak,6,6,0
2023,MRT,Selangor,231,186,45
2023,MUS,Johor,2327,1178,1149
2023,MUS,Kedah,82,36,46
2023,MUS,Kelantan,0,0,0
2023,MUS,Pahang,1,1,0
2023,MUS,Perak,15,9,6
2023,MUS,Perlis,20,17,3
2023,MUS,Pulau Pinang,100,55,45
2023,MUS,Sabah,16,8,8
2023,MUS,Sarawak,15,8,7
2023,MUS,Selangor,19951,10135,9816
2023,MWI,Johor,15,9,6
2023,MWI,Pulau Pinang,1,1,0
2023,MWI,Sabah,1,0,1
2023,MWI,Sarawak,3,0,3
2023,MWI,Selangor,237,129,108
2023,MYT,Selangor,1,0,1
2023,NAM,Johor,37,20,17
2023,NAM,Kedah,3,1,2
2023,NAM,Perak,5,2,3
2023,NAM,Perlis,1,1,0
2023,NAM,Pulau Pinang,3,2,1
2023,NAM,Sabah,2,1,1
2023,NAM,Sarawak,3,3,0
2023,NAM,Selangor,273,132,141
2023,NCL,Selangor,0,0,0
2023,NER,Johor,1,1,0
2023,NER,Sabah,1,1,0
2023,NER,Selangor,34,22,12
2023,NGA,Johor,383,348,35
2023,NGA,Kedah,15,5,10
2023,NGA,Perlis,2,2,0
2023,NGA,Pulau Pinang,27,23,4
2023,NGA,Sabah,4,4,0
2023,NGA,Sarawak,101,68,33
2023,NGA,Selangor,4910,3757,1153
2023,NIC,Johor,16,4,12
2023,NIC,Kedah,7,2,5
2023,NIC,Pulau Pinang,1,0,1
2023,NIC,Sabah,1,1,0
2023,NIC,Selangor,57,35,22
2023,NLD,Johor,13025,8267,4758
2023,NLD,Kedah,4027,2020,2007
2023,NLD,Kelantan,53,34,19
2023,NLD,Melaka,18,14,4
2023,NLD,Negeri Sembilan,5,3,2
2023,NLD,Pahang,27,15,12
2023,NLD,Perak,167,104,63
2023,NLD,Perlis,496,308,188
2023,NLD,Pulau Pinang,3044,1869,1175
2023,NLD,Sabah,788,432,356
2023,NLD,Sarawak,1742,1070,672
2023,NLD,Selangor,56551,32459,24092
2023,NLD,Terengganu,2,2,0
2023,NLD,W.P. Labuan,43,24,19
2023,NOR,Johor,2032,1258,774
2023,NOR,Kedah,803,384,419
2023,NOR,Kelantan,29,20,9
2023,NOR,Melaka,1,1,0
2023,NOR,Pahang,0,0,0
2023,NOR,Perak,15,10,5
2023,NOR,Perlis,120,65,55
2023,NOR,Pulau Pinang,394,232,162
2023,NOR,Sabah,93,63,30
2023,NOR,Sarawak,224,160,64
2023,NOR,Selangor,8279,4950,3329
2023,NOR,W.P. Labuan,14,10,4
2023,NPL,Johor,9068,6627,2441
2023,NPL,Kedah,161,98,63
2023,NPL,Pahang,2,2,0
2023,NPL,Perak,3,3,0
2023,NPL,Perlis,8,7,1
2023,NPL,Pulau Pinang,253,208,45
2023,NPL,Sabah,44,38,6
2023,NPL,Sarawak,2954,2085,869
2023,NPL,Selangor,152587,145584,7003
2023,NPL,W.P. Labuan,567,529,38
2023,NRU,Johor,50,28,22
2023,NRU,Pulau Pinang,0,0,0
2023,NRU,Selangor,28,21,7
2023,NZL,Johor,9617,5782,3835
2023,NZL,Kedah,1207,680,527
2023,NZL,Kelantan,38,26,12
2023,NZL,Melaka,10,6,4
2023,NZL,Negeri Sembilan,4,3,1
2023,NZL,Pahang,58,32,26
2023,NZL,Perak,304,160,144
2023,NZL,Perlis,254,153,101
2023,NZL,Pulau Pinang,2821,1603,1218
2023,NZL,Sabah,626,340,286
2023,NZL,Sarawak,1703,949,754
2023,NZL,Selangor,36581,21315,15266
2023,NZL,Terengganu,2,2,0
2023,NZL,W.P. Labuan,32,22,10
2023,OMN,Johor,765,364,401
2023,OMN,Kedah,74,45,29
2023,OMN,Kelantan,5,5,0
2023,OMN,Melaka,1,1,0
2023,OMN,Perak,14,9,5
2023,OMN,Perlis,23,18,5
2023,OMN,Pulau Pinang,152,87,65
2023,OMN,Sabah,7,2,5
2023,OMN,Sarawak,113,60,53
2023,OMN,Selangor,18284,10413,7871
2023,OMN,W.P. Labuan,1,1,0
2023,PAK,Johor,10665,7694,2971
2023,PAK,Kedah,1273,900,373
2023,PAK,Kelantan,133,131,2
2023,PAK,Melaka,5,5,0
2023,PAK,Negeri Sembilan,2,2,0
2023,PAK,Pahang,3,3,0
2023,PAK,Perak,264,249,15
2023,PAK,Perlis,269,256,13
2023,PAK,Pulau Pinang,1185,1072,113
2023,PAK,Sabah,175,151,24
2023,PAK,Sarawak,1669,1368,301
2023,PAK,Selangor,142099,123547,18552
2023,PAK,W.P. Labuan,32,22,10
2023,PAN,Johor,70,33,37
2023,PAN,Kedah,3,0,3
2023,PAN,Perak,2,2,0
2023,PAN,Perlis,1,1,0
2023,PAN,Pulau Pinang,13,8,5
2023,PAN,Sabah,5,1,4
2023,PAN,Sarawak,0,0,0
2023,PAN,Selangor,326,155,171
2023,PER,Johor,379,214,165
2023,PER,Kedah,77,36,41
2023,PER,Kelantan,1,1,0
2023,PER,Pahang,2,2,0
2023,PER,Perak,3,2,1
2023,PER,Perlis,11,5,6
2023,PER,Pulau Pinang,42,20,22
2023,PER,Sabah,18,9,9
2023,PER,Sarawak,8,7,1
2023,PER,Selangor,1721,843,878
2023,PER,W.P. Labuan,0,0,0
2023,PHL,Johor,261284,82946,178338
2023,PHL,Kedah,5768,1832,3936
2023,PHL,Kelantan,334,177,157
2023,PHL,Melaka,10,3,7
2023,PHL,Negeri Sembilan,6,5,1
2023,PHL,Pahang,255,195,60
2023,PHL,Perak,817,236,581
2023,PHL,Perlis,1779,528,1251
2023,PHL,Pulau Pinang,7594,2983,4611
2023,PHL,Sabah,13925,6344,7581
2023,PHL,Sarawak,28554,11276,17278
2023,PHL,Selangor,188947,76062,112885
2023,PHL,Terengganu,4,4,0
2023,PHL,W.P. Labuan,1303,414,889
2023,PLW,Johor,7,4,3
2023,PLW,Pulau Pinang,2,2,0
2023,PLW,Selangor,15,8,7
2023,PNG,Johor,243,125,118
2023,PNG,Kedah,4,2,2
2023,PNG,Kelantan,0,0,0
2023,PNG,Perak,5,4,1
2023,PNG,Pulau Pinang,21,13,8
2023,PNG,Sabah,9,4,5
2023,PNG,Sarawak,64,35,29
2023,PNG,Selangor,794,516,278
2023,POL,Johor,5136,2719,2417
2023,POL,Kedah,1570,761,809
2023,POL,Kelantan,19,11,8
2023,POL,Melaka,0,0,0
2023,POL,Negeri Sembilan,0,0,0
2023,POL,Pahang,21,12,9
2023,POL,Perak,35,17,18
2023,POL,Perlis,243,145,98
2023,POL,Pulau Pinang,711,404,307
2023,POL,Sabah,337,177,160
2023,POL,Sarawak,578,282,296
2023,POL,Selangor,15454,8131,7323
2023,POL,Terengganu,1,1,0
2023,POL,W.P. Labuan,9,7,2
2023,PRK,Selangor,0,0,0
2023,PRT,Johor,1910,1075,835
2023,PRT,Kedah,616,319,297
2023,PRT,Kelantan,6,5,1
2023,PRT,Melaka,0,0,0
2023,PRT,Pahang,2,1,1
2023,PRT,Perak,19,15,4
2023,PRT,Perlis,72,46,26
2023,PRT,Pulau Pinang,531,279,252
2023,PRT,Sabah,161,92,69
2023,PRT,Sarawak,124,66,58
2023,PRT,Selangor,8674,4996,3678
2023,PRT,W.P. Labuan,5,3,2
2023,PRY,Johor,61,36,25
2023,PRY,Kedah,2,0,2
2023,PRY,Perak,0,0,0
2023,PRY,Perlis,0,0,0
2023,PRY,Pulau Pinang,6,2,4
2023,PRY,Sabah,2,1,1
2023,PRY,Sarawak,1,1,0
2023,PRY,Selangor,154,91,63
2023,PSE,Johor,255,231,24
2023,PSE,Kedah,6,4,2
2023,PSE,Kelantan,4,4,0
2023,PSE,Melaka,3,3,0
2023,PSE,Perak,5,4,1
2023,PSE,Perlis,0,0,0
2023,PSE,Pulau Pinang,10,10,0
2023,PSE,Sabah,4,4,0
2023,PSE,Sarawak,28,23,5
2023,PSE,Selangor,4029,2743,1286
2023,QAT,Johor,244,131,113
2023,QAT,Kedah,17,10,7
2023,QAT,Perlis,4,4,0
2023,QAT,Pulau Pinang,36,19,17
2023,QAT,Sabah,1,1,0
2023,QAT,Sarawak,11,9,2
2023,QAT,Selangor,2412,1416,996
2023,REU,Johor,1,0,1
2023,REU,Sarawak,1,1,0
2023,ROU,Johor,1664,963,701
2023,ROU,Kedah,491,237,254
2023,ROU,Kelantan,6,4,2
2023,ROU,Negeri Sembilan,0,0,0
2023,ROU,Pahang,7,7,0
2023,ROU,Perak,8,4,4
2023,ROU,Perlis,41,19,22
2023,ROU,Pulau Pinang,245,134,111
2023,ROU,Sabah,84,47,37
2023,ROU,Sarawak,99,74,25
2023,ROU,Selangor,8037,4144,3893
2023,ROU,W.P. Labuan,2,1,1
2023,RUS,Johor,5179,2568,2611
2023,RUS,Kedah,5784,3017,2767
2023,RUS,Kelantan,663,379,284
2023,RUS,Melaka,11,9,2
2023,RUS,Negeri Sembilan,4,4,0
2023,RUS,Pahang,29,18,11
2023,RUS,Perak,54,30,24
2023,RUS,Perlis,3875,2234,1641
2023,RUS,Pulau Pinang,2452,1283,1169
2023,RUS,Sabah,465,218,247
2023,RUS,Sarawak,735,376,359
2023,RUS,Selangor,113890,57979,55911
2023,RUS,W.P. Labuan,90,53,37
2023,RWA,Johor,11,5,6
2023,RWA,Kedah,2,0,2
2023,RWA,Pulau Pinang,5,5,0
2023,RWA,Selangor,128,76,52
2023,SAU,Johor,2742,1520,1222
2023,SAU,Kedah,576,315,261
2023,SAU,Kelantan,95,51,44
2023,SAU,Melaka,0,0,0
2023,SAU,Perak,24,13,11
2023,SAU,Perlis,72,48,24
2023,SAU,Pulau Pinang,576,301,275
2023,SAU,Sabah,18,13,5
2023,SAU,Sarawak,143,103,40
2023,SAU,Selangor,52672,29549,23123
2023,SAU,W.P. Labuan,1,1,0
2023,SDN,Johor,126,80,46
2023,SDN,Kedah,9,4,5
2023,SDN,Kelantan,4,2,2
2023,SDN,Perlis,3,3,0
2023,SDN,Pulau Pinang,12,7,5
2023,SDN,Sabah,3,3,0
2023,SDN,Sarawak,56,35,21
2023,SDN,Selangor,12489,7053,5436
2023,SDN,W.P. Labuan,2,1,1
2023,SEN,Johor,90,68,22
2023,SEN,Kedah,5,2,3
2023,SEN,Kelantan,0,0,0
2023,SEN,Perak,0,0,0
2023,SEN,Perlis,1,1,0
2023,SEN,Pulau Pinang,4,2,2
2023,SEN,Sabah,1,1,0
2023,SEN,Sarawak,1,0,1
2023,SEN,Selangor,792,570,222
2023,SGP,Johor,13881786,7921416,5960370
2023,SGP,Kedah,63209,32979,30230
2023,SGP,Kelantan,935,618,317
2023,SGP,Melaka,257,187,70
2023,SGP,Negeri Sembilan,15,10,5
2023,SGP,Pahang,6362,3244,3118
2023,SGP,Perak,75563,34857,40706
2023,SGP,Perlis,3354,1866,1488
2023,SGP,Pulau Pinang,232031,114817,117214
2023,SGP,Sabah,28884,14979,13905
2023,SGP,Sarawak,53305,29520,23785
2023,SGP,Selangor,539858,278820,261038
2023,SGP,Terengganu,3,3,0
2023,SGP,W.P. Labuan,150,123,27
2023,SGS,Johor,0,0,0
2023,SGS,Sabah,1,0,1
2023,SGS,Selangor,1,0,1
2023,SHN,Sarawak,1,1,0
2023,SLB,Johor,80,59,21
2023,SLB,Perlis,0,0,0
2023,SLB,Pulau Pinang,4,3,1
2023,SLB,Sabah,4,2,2
2023,SLB,Sarawak,39,11,28
2023,SLB,Selangor,79,35,44
2023,SLB,W.P. Labuan,1,0,1
2023,SLE,Johor,37,27,10
2023,SLE,Kedah,1,0,1
2023,SLE,Perak,0,0,0
2023,SLE,Perlis,1,1,0
2023,SLE,Pulau Pinang,2,1,1
2023,SLE,Sabah,1,1,0
2023,SLE,Selangor,253,163,90
2023,SLV,Johor,25,9,16
2023,SLV,Kedah,8,6,2
2023,SLV,Perak,1,0,1
2023,SLV,Perlis,2,1,1
2023,SLV,Pulau Pinang,16,10,6
2023,SLV,Sabah,5,4,1
2023,SLV,Selangor,193,107,86
2023,SLV,W.P. Labuan,0,0,0
2023,SMR,Johor,4,3,1
2023,SMR,Kedah,2,0,2
2023,SMR,Selangor,31,19,12
2023,SOM,Johor,1,1,0
2023,SOM,Kedah,3,3,0
2023,SOM,Kelantan,1,0,1
2023,SOM,Perlis,1,0,1
2023,SOM,Sabah,1,0,1
2023,SOM,Sarawak,0,0,0
2023,SOM,Selangor,2729,1669,1060
2023,SRB,Johor,106,66,40
2023,SRB,Kedah,37,25,12
2023,SRB,Kelantan,1,1,0
2023,SRB,Pahang,0,0,0
2023,SRB,Perak,1,0,1
2023,SRB,Perlis,1,0,1
2023,SRB,Pulau Pinang,47,23,24
2023,SRB,Sabah,6,3,3
2023,SRB,Sarawak,7,3,4
2023,SRB,Selangor,903,485,418
2023,SSD,Johor,13,8,5
2023,SSD,Kedah,0,0,0
2023,SSD,Sarawak,8,8,0
2023,SSD,Selangor,368,221,147
2023,SSD,W.P. Labuan,0,0,0
2023,STP,Selangor,22,18,4
2023,SUR,Johor,58,22,36
2023,SUR,Kedah,1,0,1
2023,SUR,Kelantan,1,1,0
2023,SUR,Perak,1,1,0
2023,SUR,Perlis,6,6,0
2023,SUR,Pulau Pinang,8,6,2
2023,SUR,Sabah,2,0,2
2023,SUR,Sarawak,0,0,0
2023,SUR,Selangor,265,165,100
2023,SVK,Johor,496,284,212
2023,SVK,Kedah,767,394,373
2023,SVK,Kelantan,10,8,2
2023,SVK,Negeri Sembilan,1,1,0
2023,SVK,Pahang,0,0,0
2023,SVK,Perak,5,3,2
2023,SVK,Perlis,38,27,11
2023,SVK,Pulau Pinang,174,120,54
2023,SVK,Sabah,55,30,25
2023,SVK,Sarawak,34,22,12
2023,SVK,Selangor,3804,2108,1696
2023,SVK,W.P. Labuan,33,21,12
2023,SVN,Johor,258,130,128
2023,SVN,Kedah,174,88,86
2023,SVN,Kelantan,0,0,0
2023,SVN,Perak,1,1,0
2023,SVN,Perlis,14,9,5
2023,SVN,Pulau Pinang,54,23,31
2023,SVN,Sabah,26,15,11
2023,SVN,Sarawak,18,11,7
2023,SVN,Selangor,1674,942,732
2023,SVN,W.P. Labuan,8,2,6
2023,SWE,Johor,3191,1875,1316
2023,SWE,Kedah,2120,988,1132
2023,SWE,Kelantan,88,58,30
2023,SWE,Melaka,2,2,0
2023,SWE,Negeri Sembilan,1,1,0
2023,SWE,Pahang,4,3,1
2023,SWE,Perak,71,58,13
2023,SWE,Perlis,204,147,57
2023,SWE,Pulau Pinang,922,599,323
2023,SWE,Sabah,246,135,111
2023,SWE,Sarawak,314,210,104
2023,SWE,Selangor,13508,8125,5383
2023,SWE,W.P. Labuan,10,8,2
2023,SWZ,Johor,22,12,10
2023,SWZ,Kedah,1,0,1
2023,SWZ,Pulau Pinang,0,0,0
2023,SWZ,Sabah,1,0,1
2023,SWZ,Selangor,218,100,118
2023,SYC,Johor,84,32,52
2023,SYC,Kedah,4,3,1
2023,SYC,Pulau Pinang,6,3,3
2023,SYC,Sabah,2,2,0
2023,SYC,Sarawak,6,5,1
2023,SYC,Selangor,973,388,585
2023,SYR,Johor,166,110,56
2023,SYR,Kedah,11,11,0
2023,SYR,Kelantan,3,2,1
2023,SYR,Melaka,1,1,0
2023,SYR,Pahang,9,9,0
2023,SYR,Perlis,5,5,0
2023,SYR,Pulau Pinang,30,25,5
2023,SYR,Sabah,7,4,3
2023,SYR,Sarawak,30,28,2
2023,SYR,Selangor,8027,5089,2938
2023,SYR,W.P. Labuan,2,2,0
2023,TCA,Perlis,1,0,1
2023,TCA,Selangor,1,0,1
2023,TCD,Johor,36,32,4
2023,TCD,Kedah,3,3,0
2023,TCD,Perlis,3,3,0
2023,TCD,Selangor,303,232,71
2023,TGO,Johor,26,20,6
2023,TGO,Perak,1,1,0
2023,TGO,Pulau Pinang,2,1,1
2023,TGO,Selangor,96,75,21
2023,THA,Johor,83470,23855,59615
2023,THA,Kedah,789859,463879,325980
2023,THA,Kelantan,530654,278983,251671
2023,THA,Melaka,127,71,56
2023,THA,Negeri Sembilan,8,6,2
2023,THA,Pahang,167,113,54
2023,THA,Perak,129535,60055,69480
2023,THA,Perlis,637321,377556,259765
2023,THA,Pulau Pinang,26401,10610,15791
2023,THA,Sabah,731,262,469
2023,THA,Sarawak,4356,1598,2758
2023,THA,Selangor,159496,63278,96218
2023,THA,Terengganu,5,2,3
2023,THA,W.P. Labuan,92,37,55
2023,TJK,Johor,43,30,13
2023,TJK,Kedah,4,1,3
2023,TJK,Kelantan,1,1,0
2023,TJK,Perlis,4,3,1
2023,TJK,Pulau Pinang,10,6,4
2023,TJK,Sabah,8,6,2
2023,TJK,Selangor,1358,952,406
2023,TKL,Selangor,0,0,0
2023,TKM,Johor,21,10,11
2023,TKM,Kedah,9,5,4
2023,TKM,Kelantan,1,0,1
2023,TKM,Perlis,1,1,0
2023,TKM,Pulau Pinang,7,6,1
2023,TKM,Sabah,3,1,2
2023,TKM,Sarawak,15,15,0
2023,TKM,Selangor,1311,801,510
2023,TLS,Johor,61,25,36
2023,TLS,Kedah,13,4,9
2023,TLS,Perlis,1,1,0
2023,TLS,Pulau Pinang,75,37,38
2023,TLS,Sabah,9,7,2
2023,TLS,Sarawak,35,20,15
2023,TLS,Selangor,2423,1388,1035
2023,TON,Johor,5,2,3
2023,TON,Pulau Pinang,28,12,16
2023,TON,Sarawak,0,0,0
2023,TON,Selangor,156,69,87
2023,TTO,Johor,71,36,35
2023,TTO,Kedah,6,2,4
2023,TTO,Pahang,2,1,1
2023,TTO,Pulau Pinang,15,8,7
2023,TTO,Sabah,5,2,3
2023,TTO,Sarawak,24,12,12
2023,TTO,Selangor,408,233,175
2023,TUN,Johor,152,85,67
2023,TUN,Kedah,41,27,14
2023,TUN,Kelantan,5,5,0
2023,TUN,Melaka,2,1,1
2023,TUN,Perak,2,1,1
2023,TUN,Perlis,7,5,2
2023,TUN,Pulau Pinang,51,36,15
2023,TUN,Sabah,14,7,7
2023,TUN,Sarawak,13,9,4
2023,TUN,Selangor,9904,4913,4991
2023,TUN,W.P. Labuan,2,0,2
2023,TUR,Johor,3473,2477,996
2023,TUR,Kedah,571,369,202
2023,TUR,Kelantan,31,25,6
2023,TUR,Melaka,6,6,0
2023,TUR,Negeri Sembilan,2,1,1
2023,TUR,Pahang,9,6,3
2023,TUR,Perak,19,15,4
2023,TUR,Perlis,246,204,42
2023,TUR,Pulau Pinang,437,311,126
2023,TUR,Sabah,76,48,28
2023,TUR,Sarawak,257,187,70
2023,TUR,Selangor,16546,11269,5277
2023,TUR,W.P. Labuan,2,2,0
2023,TUV,Selangor,4,3,1
2023,TWN,Johor,72512,31364,41148
2023,TWN,Kedah,1837,910,927
2023,TWN,Kelantan,16,10,6
2023,TWN,Melaka,44,21,23
2023,TWN,Negeri Sembilan,0,0,0
2023,TWN,Pahang,63,30,33
2023,TWN,Perak,695,378,317
2023,TWN,Perlis,257,117,140
2023,TWN,Pulau Pinang,46672,22930,23742
2023,TWN,Sabah,11460,5538,5922
2023,TWN,Sarawak,3959,1777,2182
2023,TWN,Selangor,176479,84654,91825
2023,TWN,W.P. Labuan,106,55,51
2023,TZA,Johor,293,175,118
2023,TZA,Kedah,15,6,9
2023,TZA,Perak,2,2,0
2023,TZA,Perlis,2,2,0
2023,TZA,Pulau Pinang,6,4,2
2023,TZA,Sabah,2,0,2
2023,TZA,Sarawak,40,39,1
2023,TZA,Selangor,2287,1157,1130
2023,TZA,W.P. Labuan,1,1,0
2023,UGA,Johor,198,78,120
2023,UGA,Kedah,14,3,11
2023,UGA,Perak,0,0,0
2023,UGA,Perlis,4,1,3
2023,UGA,Pulau Pinang,17,9,8
2023,UGA,Sabah,1,1,0
2023,UGA,Sarawak,5,4,1
2023,UGA,Selangor,1403,663,740
2023,UKR,Johor,1270,701,569
2023,UKR,Kedah,420,171,249
2023,UKR,Kelantan,34,26,8
2023,UKR,Melaka,16,16,0
2023,UKR,Negeri Sembilan,0,0,0
2023,UKR,Pahang,27,25,2
2023,UKR,Perak,14,7,7
2023,UKR,Perlis,96,51,45
2023,UKR,Pulau Pinang,271,138,133
2023,UKR,Sabah,67,35,32
2023,UKR,Sarawak,45,28,17
2023,UKR,Selangor,11458,5470,5988
2023,UKR,W.P. Labuan,11,3,8
2023,URY,Johor,218,87,131
2023,URY,Kedah,12,8,4
2023,URY,Kelantan,2,1,1
2023,URY,Perak,0,0,0
2023,URY,Perlis,1,1,0
2023,URY,Pulau Pinang,7,4,3
2023,URY,Sabah,5,3,2
2023,URY,Sarawak,8,3,5
2023,URY,Selangor,1111,545,566
2023,URY,W.P. Labuan,4,2,2
2023,USA,Johor,53470,30922,22548
2023,USA,Kedah,6967,3746,3221
2023,USA,Kelantan,154,102,52
2023,USA,Melaka,38,23,15
2023,USA,Negeri Sembilan,3,2,1
2023,USA,Pahang,148,99,49
2023,USA,Perak,1803,955,848
2023,USA,Perlis,1335,848,487
2023,USA,Pulau Pinang,24538,14691,9847
2023,USA,Sabah,3741,2001,1740
2023,USA,Sarawak,3618,2067,1551
2023,USA,Selangor,171426,99735,71691
2023,USA,Terengganu,3,3,0
2023,USA,W.P. Labuan,96,67,29
2023,UZB,Johor,1141,897,244
2023,UZB,Kedah,165,95,70
2023,UZB,Kelantan,7,4,3
2023,UZB,Perak,3,1,2
2023,UZB,Perlis,26,18,8
2023,UZB,Pulau Pinang,167,62,105
2023,UZB,Sabah,47,36,11
2023,UZB,Sarawak,12,3,9
2023,UZB,Selangor,14559,8686,5873
2023,VAT,Johor,0,0,0
2023,VAT,Pulau Pinang,1,1,0
2023,VAT,Sarawak,1,1,0
2023,VAT,Selangor,3,3,0
2023,VCT,Johor,5,2,3
2023,VCT,Kedah,1,1,0
2023,VCT,Pulau Pinang,1,0,1
2023,VCT,Sarawak,4,4,0
2023,VCT,Selangor,32,15,17
2023,VEN,Johor,169,91,78
2023,VEN,Kedah,24,9,15
2023,VEN,Kelantan,0,0,0
2023,VEN,Melaka,0,0,0
2023,VEN,Perak,0,0,0
2023,VEN,Perlis,2,0,2
2023,VEN,Pulau Pinang,24,16,8
2023,VEN,Sabah,20,10,10
2023,VEN,Sarawak,40,30,10
2023,VEN,Selangor,969,522,447
2023,VEN,W.P. Labuan,2,2,0
2023,VNM,Johor,184200,59883,124317
2023,VNM,Kedah,3718,605,3113
2023,VNM,Kelantan,164,61,103
2023,VNM,Melaka,4,1,3
2023,VNM,Negeri Sembilan,1,0,1
2023,VNM,Pahang,22,14,8
2023,VNM,Perak,1783,152,1631
2023,VNM,Perlis,2612,277,2335
2023,VNM,Pulau Pinang,17443,5390,12053
2023,VNM,Sabah,264,85,179
2023,VNM,Sarawak,2587,529,2058
2023,VNM,Selangor,189311,68099,121212
2023,VNM,Terengganu,2,2,0
2023,VNM,W.P. Labuan,34,21,13
2023,VUT,Johor,517,379,138
2023,VUT,Kedah,3,2,1
2023,VUT,Pulau Pinang,57,42,15
2023,VUT,Sabah,9,9,0
2023,VUT,Sarawak,2,1,1
2023,VUT,Selangor,827,685,142
2023,WSM,Johor,11,7,4
2023,WSM,Sarawak,1,0,1
2023,WSM,Selangor,45,17,28
2023,XXX,Johor,960,575,385
2023,XXX,Kedah,82,41,41
2023,XXX,Kelantan,4,1,3
2023,XXX,Melaka,0,0,0
2023,XXX,Pahang,2,0,2
2023,XXX,Perak,32,15,17
2023,XXX,Perlis,17,13,4
2023,XXX,Pulau Pinang,594,325,269
2023,XXX,Sabah,196,113,83
2023,XXX,Sarawak,374,264,110
2023,XXX,Selangor,4395,2634,1761
2023,XXX,W.P. Labuan,8,5,3
2023,YEM,Johor,394,275,119
2023,YEM,Kedah,44,38,6
2023,YEM,Kelantan,11,8,3
2023,YEM,Melaka,18,10,8
2023,YEM,Pahang,2,2,0
2023,YEM,Perak,4,4,0
2023,YEM,Perlis,16,16,0
2023,YEM,Pulau Pinang,44,35,9
2023,YEM,Sabah,6,6,0
2023,YEM,Sarawak,35,18,17
2023,YEM,Selangor,16025,11027,4998
2023,YEM,W.P. Labuan,0,0,0
2023,ZAF,Johor,3378,2026,1352
2023,ZAF,Kedah,592,325,267
2023,ZAF,Kelantan,21,15,6
2023,ZAF,Melaka,1,1,0
2023,ZAF,Pahang,15,9,6
2023,ZAF,Perak,25,17,8
2023,ZAF,Perlis,164,100,64
2023,ZAF,Pulau Pinang,623,335,288
2023,ZAF,Sabah,190,97,93
2023,ZAF,Sarawak,1154,572,582
2023,ZAF,Selangor,13393,7452,5941
2023,ZAF,Terengganu,3,3,0
2023,ZAF,W.P. Labuan,62,28,34
2023,ZAR,Selangor,5,3,2
2023,ZMB,Johor,59,29,30
2023,ZMB,Kedah,7,4,3
2023,ZMB,Perak,0,0,0
2023,ZMB,Perlis,1,1,0
2023,ZMB,Pulau Pinang,7,3,4
2023,ZMB,Sabah,1,0,1
2023,ZMB,Sarawak,8,5,3
2023,ZMB,Selangor,887,463,424
2023,ZWE,Johor,130,64,66
2023,ZWE,Kedah,13,5,8
2023,ZWE,Kelantan,0,0,0
2023,ZWE,Perak,1,0,1
2023,ZWE,Perlis,7,4,3
2023,ZWE,Pulau Pinang,27,13,14
2023,ZWE,Sabah,6,4,2
2023,ZWE,Sarawak,7,7,0
2023,ZWE,Selangor,1834,858,976
2024,AFG,Johor,1,1,0
2024,AFG,Perlis,3,2,1
2024,AFG,Pulau Pinang,4,4,0
2024,AFG,Sarawak,3,3,0
2024,AFG,Selangor,322,244,78
2024,AGO,Johor,1,1,0
2024,AGO,Selangor,33,21,12
2024,AIA,Selangor,2,1,1
2024,ALB,Johor,83,61,22
2024,ALB,Kedah,10,6,4
2024,ALB,Perak,1,1,0
2024,ALB,Perlis,1,0,1
2024,ALB,Pulau Pinang,55,18,37
2024,ALB,Sabah,4,3,1
2024,ALB,Sarawak,1,1,0
2024,ALB,Selangor,205,116,89
2024,AND,Johor,1,0,1
2024,AND,Perlis,1,1,0
2024,AND,Pulau Pinang,3,3,0
2024,AND,Selangor,50,33,17
2024,ANT,Selangor,1,0,1
2024,ARE,Johor,103,46,57
2024,ARE,Kedah,51,35,16
2024,ARE,Kelantan,1,0,1
2024,ARE,Perak,1,1,0
2024,ARE,Pulau Pinang,28,23,5
2024,ARE,Sabah,5,4,1
2024,ARE,Selangor,2319,1406,913
2024,ARG,Johor,577,305,272
2024,ARG,Kedah,526,249,277
2024,ARG,Kelantan,4,1,3
2024,ARG,Perak,3,2,1
2024,ARG,Perlis,31,19,12
2024,ARG,Pulau Pinang,65,32,33
2024,ARG,Sabah,24,11,13
2024,ARG,Sarawak,28,23,5
2024,ARG,Selangor,3278,1669,1609
2024,ARG,Terengganu,1,1,0
2024,ARM,Johor,41,15,26
2024,ARM,Kedah,15,6,9
2024,ARM,Pulau Pinang,10,4,6
2024,ARM,Sabah,7,3,4
2024,ARM,Selangor,536,225,311
2024,ATA,Selangor,1,1,0
2024,ATG,Johor,21,14,7
2024,ATG,Kedah,3,0,3
2024,ATG,Pulau Pinang,4,4,0
2024,ATG,Sabah,2,0,2
2024,ATG,Selangor,81,49,32
2024,AUS,Johor,32653,19070,13583
2024,AUS,Kedah,4674,2499,2175
2024,AUS,Kelantan,80,57,23
2024,AUS,Melaka,13,10,3
2024,AUS,Negeri Sembilan,9,7,2
2024,AUS,Pahang,257,134,123
2024,AUS,Perak,1443,747,696
2024,AUS,Perlis,550,343,207
2024,AUS,Pulau Pinang,12798,6671,6127
2024,AUS,Sabah,2694,1397,1297
2024,AUS,Sarawak,3865,2199,1666
2024,AUS,Selangor,154448,88274,66174
2024,AUS,Terengganu,11,5,6
2024,AUS,W.P. Labuan,55,34,21
2024,AUT,Johor,1240,844,396
2024,AUT,Kedah,767,401,366
2024,AUT,Kelantan,28,25,3
2024,AUT,Negeri Sembilan,2,1,1
2024,AUT,Pahang,1,0,1
2024,AUT,Perak,17,11,6
2024,AUT,Perlis,73,45,28
2024,AUT,Pulau Pinang,496,343,153
2024,AUT,Sabah,102,55,47
2024,AUT,Sarawak,134,80,54
2024,AUT,Selangor,5613,3368,2245
2024,AUT,W.P. Labuan,5,3,2
2024,AZE,Johor,93,49,44
2024,AZE,Kedah,48,19,29
2024,AZE,Kelantan,1,1,0
2024,AZE,Perlis,1,1,0
2024,AZE,Pulau Pinang,18,12,6
2024,AZE,Sabah,2,2,0
2024,AZE,Sarawak,6,3,3
2024,AZE,Selangor,1039,537,502
2024,AZE,W.P. Labuan,1,0,1
2024,BDI,Johor,1,1,0
2024,BDI,Pulau Pinang,2,2,0
2024,BDI,Sarawak,2,1,1
2024,BDI,Selangor,23,16,7
2024,BEL,Johor,1584,944,640
2024,BEL,Kedah,864,451,413
2024,BEL,Kelantan,15,7,8
2024,BEL,Melaka,5,3,2
2024,BEL,Pahang,7,2,5
2024,BEL,Perak,16,11,5
2024,BEL,Perlis,90,58,32
2024,BEL,Pulau Pinang,527,343,184
2024,BEL,Sabah,164,87,77
2024,BEL,Sarawak,178,101,77
2024,BEL,Selangor,9215,5420,3795
2024,BEL,Terengganu,1,1,0
2024,BEL,W.P. Labuan,6,3,3
2024,BEN,Johor,9,6,3
2024,BEN,Pulau Pinang,1,1,0
2024,BEN,Sarawak,1,0,1
2024,BEN,Selangor,67,48,19
2024,BFA,Johor,2,1,1
2024,BFA,Pulau Pinang,1,1,0
2024,BFA,Selangor,57,49,8
2024,BGD,Johor,17575,14162,3413
2024,BGD,Kedah,704,430,274
2024,BGD,Kelantan,14,14,0
2024,BGD,Negeri Sembilan,2,2,0
2024,BGD,Pahang,3,1,2
2024,BGD,Perak,21,19,2
2024,BGD,Perlis,14,10,4
2024,BGD,Pulau Pinang,1331,1182,149
2024,BGD,Sabah,29,25,4
2024,BGD,Sarawak,691,517,174
2024,BGD,Selangor,204543,190897,13646
2024,BGD,Terengganu,1,1,0
2024,BGD,W.P. Labuan,54,49,5
2024,BGR,Johor,373,206,167
2024,BGR,Kedah,130,63,67
2024,BGR,Kelantan,3,3,0
2024,BGR,Perak,8,6,2
2024,BGR,Perlis,3,3,0
2024,BGR,Pulau Pinang,84,58,26
2024,BGR,Sabah,15,9,6
2024,BGR,Sarawak,14,12,2
2024,BGR,Selangor,2193,1122,1071
2024,BHR,Johor,76,43,33
2024,BHR,Kedah,27,15,12
2024,BHR,Perlis,1,1,0
2024,BHR,Pulau Pinang,25,9,16
2024,BHR,Sabah,1,0,1
2024,BHR,Sarawak,1,1,0
2024,BHR,Selangor,1032,564,468
2024,BHS,Johor,5,3,2
2024,BHS,Perlis,1,1,0
2024,BHS,Pulau Pinang,1,0,1
2024,BHS,Selangor,50,25,25
2024,BIH,Johor,62,35,27
2024,BIH,Kedah,7,2,5
2024,BIH,Perlis,1,1,0
2024,BIH,Pulau Pinang,9,7,2
2024,BIH,Sabah,4,4,0
2024,BIH,Sarawak,6,6,0
2024,BIH,Selangor,446,262,184
2024,BLR,Johor,79,36,43
2024,BLR,Kedah,165,69,96
2024,BLR,Kelantan,17,9,8
2024,BLR,Perak,1,1,0
2024,BLR,Perlis,3,1,2
2024,BLR,Pulau Pinang,68,28,40
2024,BLR,Sabah,25,11,14
2024,BLR,Sarawak,11,7,4
2024,BLR,Selangor,3021,1402,1619
2024,BLR,W.P. Labuan,1,1,0
2024,BLZ,Johor,17,15,2
2024,BLZ,Pulau Pinang,1,1,0
2024,BLZ,Selangor,41,19,22
2024,BMU,Selangor,3,0,3
2024,BOL,Johor,21,9,12
2024,BOL,Kedah,1,1,0
2024,BOL,Pulau Pinang,7,4,3
2024,BOL,Sarawak,10,5,5
2024,BOL,Selangor,136,73,63
2024,BRA,Johor,1764,966,798
2024,BRA,Kedah,650,311,339
2024,BRA,Kelantan,4,3,1
2024,BRA,Pahang,4,1,3
2024,BRA,Perak,16,7,9
2024,BRA,Perlis,48,18,30
2024,BRA,Pulau Pinang,190,112,78
2024,BRA,Sabah,59,28,31
2024,BRA,Sarawak,40,26,14
2024,BRA,Selangor,6545,3696,2849
2024,BRB,Johor,16,4,12
2024,BRB,Kedah,2,2,0
2024,BRB,Pulau Pinang,3,0,3
2024,BRB,Selangor,44,21,23
2024,BRN,Johor,2349,1204,1145
2024,BRN,Kedah,182,101,81
2024,BRN,Kelantan,63,27,36
2024,BRN,Melaka,5,2,3
2024,BRN,Pahang,1,0,1
2024,BRN,Perak,27,13,14
2024,BRN,Perlis,191,93,98
2024,BRN,Pulau Pinang,119,48,71
2024,BRN,Sabah,6700,2869,3831
2024,BRN,Sarawak,835974,448691,387283
2024,BRN,Selangor,32034,15581,16453
2024,BRN,W.P. Labuan,7633,4777,2856
2024,BTN,Johor,49,37,12
2024,BTN,Kedah,4,4,0
2024,BTN,Perak,4,2,2
2024,BTN,Perlis,5,2,3
2024,BTN,Pulau Pinang,84,44,40
2024,BTN,Sabah,1,0,1
2024,BTN,Sarawak,3,3,0
2024,BTN,Selangor,422,266,156
2024,BWA,Johor,4,3,1
2024,BWA,Kedah,3,1,2
2024,BWA,Pulau Pinang,1,0,1
2024,BWA,Sarawak,1,1,0
2024,BWA,Selangor,91,40,51
2024,CAF,Selangor,1,1,0
2024,CAN,Johor,9880,5493,4387
2024,CAN,Kedah,1810,963,847
2024,CAN,Kelantan,41,32,9
2024,CAN,Melaka,4,3,1
2024,CAN,Negeri Sembilan,13,8,5
2024,CAN,Pahang,31,18,13
2024,CAN,Perak,189,102,87
2024,CAN,Perlis,302,182,120
2024,CAN,Pulau Pinang,3645,1963,1682
2024,CAN,Sabah,1170,582,588
2024,CAN,Sarawak,2271,1233,1038
2024,CAN,Selangor,31161,17689,13472
2024,CAN,Terengganu,1,1,0
2024,CAN,W.P. Labuan,43,25,18
2024,CCK,Selangor,1,0,1
2024,CHE,Johor,2685,1586,1099
2024,CHE,Kedah,1314,687,627
2024,CHE,Kelantan,14,7,7
2024,CHE,Melaka,1,1,0
2024,CHE,Negeri Sembilan,10,6,4
2024,CHE,Pahang,21,11,10
2024,CHE,Perak,62,39,23
2024,CHE,Perlis,188,105,83
2024,CHE,Pulau Pinang,952,607,345
2024,CHE,Sabah,266,140,126
2024,CHE,Sarawak,242,119,123
2024,CHE,Selangor,9590,5663,3927
2024,CHE,W.P. Labuan,1,1,0
2024,CHL,Johor,272,131,141
2024,CHL,Kedah,142,59,83
2024,CHL,Kelantan,7,4,3
2024,CHL,Pahang,1,1,0
2024,CHL,Perlis,25,18,7
2024,CHL,Pulau Pinang,56,34,22
2024,CHL,Sabah,26,13,13
2024,CHL,Sarawak,8,7,1
2024,CHL,Selangor,2244,1107,1137
2024,CHN,Johor,469510,205170,264340
2024,CHN,Kedah,16417,7178,9239
2024,CHN,Kelantan,191,115,76
2024,CHN,Melaka,52,43,9
2024,CHN,Negeri Sembilan,10,10,0
2024,CHN,Pahang,320,196,124
2024,CHN,Perak,2164,986,1178
2024,CHN,Perlis,2779,1476,1303
2024,CHN,Pulau Pinang,75408,37488,37920
2024,CHN,Sabah,123374,52952,70422
2024,CHN,Sarawak,10246,5234,5012
2024,CHN,Selangor,940857,459989,480868
2024,CHN,W.P. Labuan,287,238,49
2024,CIV,Johor,6,5,1
2024,CIV,Pulau Pinang,1,0,1
2024,CIV,Sabah,2,0,2
2024,CIV,Sarawak,2,1,1
2024,CIV,Selangor,115,75,40
2024,CMR,Johor,4,1,3
2024,CMR,Kedah,4,1,3
2024,CMR,Pulau Pinang,4,2,2
2024,CMR,Sabah,1,1,0
2024,CMR,Selangor,172,110,62
2024,COD,Johor,15,13,2
2024,COD,Sabah,2,2,0
2024,COD,Sarawak,1,1,0
2024,COD,Selangor,125,83,42
2024,COG,Selangor,17,13,4
2024,COL,Johor,202,92,110
2024,COL,Kedah,42,18,24
2024,COL,Perak,5,5,0
2024,COL,Pulau Pinang,44,23,21
2024,COL,Sabah,16,8,8
2024,COL,Sarawak,12,7,5
2024,COL,Selangor,1324,702,622
2024,COL,W.P. Labuan,1,1,0
2024,COM,Johor,6,3,3
2024,COM,Kedah,2,0,2
2024,COM,Pulau Pinang,1,1,0
2024,COM,Selangor,110,63,47
2024,CPV,Johor,3,1,2
2024,CPV,Selangor,15,8,7
2024,CRI,Johor,100,63,37
2024,CRI,Kedah,8,3,5
2024,CRI,Pulau Pinang,75,52,23
2024,CRI,Sabah,7,4,3
2024,CRI,Sarawak,4,4,0
2024,CRI,Selangor,421,211,210
2024,CUB,Johor,61,41,20
2024,CUB,Kedah,1,0,1
2024,CUB,Pulau Pinang,8,5,3
2024,CUB,Sabah,4,1,3
2024,CUB,Selangor,136,71,65
2024,CYP,Johor,39,24,15
2024,CYP,Kedah,12,7,5
2024,CYP,Pulau Pinang,16,8,8
2024,CYP,Sabah,5,3,2
2024,CYP,Sarawak,3,1,2
2024,CYP,Selangor,482,318,164
2024,CZE,Johor,766,400,366
2024,CZE,Kedah,1005,476,529
2024,CZE,Kelantan,5,5,0
2024,CZE,Perak,4,2,2
2024,CZE,Perlis,60,37,23
2024,CZE,Pulau Pinang,219,124,95
2024,CZE,Sabah,79,43,36
2024,CZE,Sarawak,98,65,33
2024,CZE,Selangor,4816,2737,2079
2024,CZE,W.P. Labuan,19,8,11
2024,DEU,Johor,14839,8941,5898
2024,DEU,Kedah,8828,4491,4337
2024,DEU,Kelantan,72,52,20
2024,DEU,Melaka,18,12,6
2024,DEU,Negeri Sembilan,13,6,7
2024,DEU,Pahang,70,42,28
2024,DEU,Perak,181,127,54
2024,DEU,Perlis,849,508,341
2024,DEU,Pulau Pinang,4792,3285,1507
2024,DEU,Sabah,923,520,403
2024,DEU,Sarawak,1428,837,591
2024,DEU,Selangor,61701,35499,26202
2024,DEU,W.P. Labuan,52,30,22
2024,DJI,Johor,4,2,2
2024,DJI,Kedah,2,1,1
2024,DJI,Selangor,78,46,32
2024,DMA,Johor,34,22,12
2024,DMA,Kedah,13,7,6
2024,DMA,Perak,1,1,0
2024,DMA,Pulau Pinang,15,12,3
2024,DMA,Sabah,2,1,1
2024,DMA,Sarawak,3,1,2
2024,DMA,Selangor,308,231,77
2024,DNK,Johor,1842,1316,526
2024,DNK,Kedah,1468,690,778
2024,DNK,Kelantan,20,15,5
2024,DNK,Melaka,1,1,0
2024,DNK,Pahang,25,8,17
2024,DNK,Perak,24,14,10
2024,DNK,Perlis,75,45,30
2024,DNK,Pulau Pinang,485,304,181
2024,DNK,Sabah,194,104,90
2024,DNK,Sarawak,93,54,39
2024,DNK,Selangor,7878,4471,3407
2024,DNK,Terengganu,19,4,15
2024,DNK,W.P. Labuan,5,2,3
2024,DOM,Johor,19,1,18
2024,DOM,Kedah,1,1,0
2024,DOM,Perlis,1,1,0
2024,DOM,Pulau Pinang,6,1,5
2024,DOM,Sabah,5,2,3
2024,DOM,Selangor,94,51,43
2024,DZA,Johor,189,146,43
2024,DZA,Kedah,44,28,16
2024,DZA,Kelantan,7,7,0
2024,DZA,Perlis,7,4,3
2024,DZA,Pulau Pinang,11,9,2
2024,DZA,Sabah,9,4,5
2024,DZA,Sarawak,21,18,3
2024,DZA,Selangor,4279,2779,1500
2024,DZA,W.P. Labuan,1,1,0
2024,ECU,Johor,87,44,43
2024,ECU,Kedah,7,3,4
2024,ECU,Perlis,1,0,1
2024,ECU,Pulau Pinang,17,6,11
2024,ECU,Sabah,3,1,2
2024,ECU,Sarawak,2,2,0
2024,ECU,Selangor,490,239,251
2024,EGY,Johor,1292,1081,211
2024,EGY,Kedah,120,71,49
2024,EGY,Kelantan,9,4,5
2024,EGY,Melaka,1,1,0
2024,EGY,Perak,1,1,0
2024,EGY,Perlis,5,5,0
2024,EGY,Pulau Pinang,126,89,37
2024,EGY,Sabah,22,15,7
2024,EGY,Sarawak,701,466,235
2024,EGY,Selangor,10835,7134,3701
2024,ERI,Johor,2,2,0
2024,ERI,Selangor,126,68,58
2024,ESP,Johor,3146,1915,1231
2024,ESP,Kedah,1318,640,678
2024,ESP,Kelantan,31,21,10
2024,ESP,Melaka,2,1,1
2024,ESP,Negeri Sembilan,6,3,3
2024,ESP,Pahang,12,9,3
2024,ESP,Perak,36,18,18
2024,ESP,Perlis,134,72,62
2024,ESP,Pulau Pinang,788,445,343
2024,ESP,Sabah,306,169,137
2024,ESP,Sarawak,322,199,123
2024,ESP,Selangor,17486,9795,7691
2024,ESP,W.P. Labuan,25,15,10
2024,EST,Johor,271,143,128
2024,EST,Kedah,375,175,200
2024,EST,Kelantan,7,4,3
2024,EST,Perlis,11,8,3
2024,EST,Pulau Pinang,82,44,38
2024,EST,Sabah,24,11,13
2024,EST,Sarawak,15,6,9
2024,EST,Selangor,1681,861,820
2024,EST,W.P. Labuan,4,1,3
2024,ETH,Johor,25,19,6
2024,ETH,Pulau Pinang,9,4,5
2024,ETH,Sarawak,2,1,1
2024,ETH,Selangor,235,156,79
2024,FIN,Johor,1575,875,700
2024,FIN,Kedah,979,451,528
2024,FIN,Kelantan,6,3,3
2024,FIN,Perak,23,12,11
2024,FIN,Perlis,57,42,15
2024,FIN,Pulau Pinang,352,226,126
2024,FIN,Sabah,102,55,47
2024,FIN,Sarawak,63,27,36
2024,FIN,Selangor,3981,2203,1778
2024,FIN,W.P. Labuan,3,2,1
2024,FJI,Johor,569,260,309
2024,FJI,Kedah,5,4,1
2024,FJI,Perlis,2,0,2
2024,FJI,Pulau Pinang,24,10,14
2024,FJI,Sabah,4,3,1
2024,FJI,Sarawak,6,6,0
2024,FJI,Selangor,757,372,385
2024,FJI,Terengganu,1,1,0
2024,FJI,W.P. Labuan,1,1,0
2024,FRA,Johor,14199,8470,5729
2024,FRA,Kedah,6189,3172,3017
2024,FRA,Kelantan,175,107,68
2024,FRA,Melaka,30,17,13
2024,FRA,Negeri Sembilan,8,3,5
2024,FRA,Pahang,169,84,85
2024,FRA,Perak,176,114,62
2024,FRA,Perlis,650,410,240
2024,FRA,Pulau Pinang,2697,1648,1049
2024,FRA,Sabah,894,502,392
2024,FRA,Sarawak,715,435,280
2024,FRA,Selangor,62248,35369,26879
2024,FRA,Terengganu,2,2,0
2024,FRA,W.P. Labuan,24,17,7
2024,FSM,Johor,2,0,2
2024,FSM,Selangor,7,5,2
2024,GAB,Johor,17,9,8
2024,GAB,Sabah,1,0,1
2024,GAB,Selangor,43,26,17
2024,GBR,Johor,31108,19661,11447
2024,GBR,Kedah,15825,8028,7797
2024,GBR,Kelantan,117,82,35
2024,GBR,Melaka,29,16,13
2024,GBR,Negeri Sembilan,7,7,0
2024,GBR,Pahang,124,90,34
2024,GBR,Perak,687,410,277
2024,GBR,Perlis,1239,801,438
2024,GBR,Pulau Pinang,18084,9736,8348
2024,GBR,Sabah,3595,1917,1678
2024,GBR,Sarawak,7580,4710,2870
2024,GBR,Selangor,131694,77224,54470
2024,GBR,Terengganu,2,2,0
2024,GBR,W.P. Labuan,294,199,95
2024,GEO,Johor,71,36,35
2024,GEO,Kedah,14,4,10
2024,GEO,Kelantan,1,1,0
2024,GEO,Perlis,1,1,0
2024,GEO,Pulau Pinang,11,9,2
2024,GEO,Sabah,7,2,5
2024,GEO,Sarawak,5,1,4
2024,GEO,Selangor,397,214,183
2024,GHA,Johor,40,36,4
2024,GHA,Kedah,4,4,0
2024,GHA,Perak,1,1,0
2024,GHA,Pulau Pinang,57,32,25
2024,GHA,Sabah,2,1,1
2024,GHA,Sarawak,2,2,0
2024,GHA,Selangor,605,401,204
2024,GIN,Johor,35,28,7
2024,GIN,Kedah,4,4,0
2024,GIN,Kelantan,1,1,0
2024,GIN,Pulau Pinang,2,1,1
2024,GIN,Sarawak,1,1,0
2024,GIN,Selangor,335,241,94
2024,GMB,Johor,13,5,8
2024,GMB,Sabah,2,2,0
2024,GMB,Selangor,156,116,40
2024,GNB,Selangor,6,5,1
2024,GNQ,Johor,2,2,0
2024,GNQ,Selangor,12,6,6
2024,GRC,Johor,399,291,108
2024,GRC,Kedah,123,78,45
2024,GRC,Kelantan,1,1,0
2024,GRC,Negeri Sembilan,1,1,0
2024,GRC,Pahang,1,1,0
2024,GRC,Perak,8,6,2
2024,GRC,Perlis,13,10,3
2024,GRC,Pulau Pinang,75,39,36
2024,GRC,Sabah,26,17,9
2024,GRC,Sarawak,25,13,12
2024,GRC,Selangor,1830,1208,622
2024,GRC,W.P. Labuan,2,2,0
2024,GRD,Johor,37,22,15
2024,GRD,Kedah,4,2,2
2024,GRD,Pulau Pinang,1,1,0
2024,GRD,Selangor,55,45,10
2024,GRL,Johor,1,0,1
2024,GRL,Selangor,1,1,0
2024,GTM,Johor,27,19,8
2024,GTM,Kedah,4,3,1
2024,GTM,Pulau Pinang,8,4,4
2024,GTM,Sabah,3,2,1
2024,GTM,Selangor,142,84,58
2024,GUY,Johor,9,7,2
2024,GUY,Pulau Pinang,4,0,4
2024,GUY,Sabah,1,1,0
2024,GUY,Selangor,46,30,16
2024,HKG,Johor,42,25,17
2024,HKG,Kedah,10,5,5
2024,HKG,Pahang,8,5,3
2024,HKG,Perak,283,123,160
2024,HKG,Perlis,6,4,2
2024,HKG,Pulau Pinang,149,61,88
2024,HKG,Sabah,13768,6038,7730
2024,HKG,Sarawak,1,1,0
2024,HKG,Selangor,1373,680,693
2024,HKG,W.P. Labuan,2,2,0
2024,HND,Johor,30,21,9
2024,HND,Kedah,2,2,0
2024,HND,Pulau Pinang,3,2,1
2024,HND,Sabah,2,0,2
2024,HND,Selangor,108,64,44
2024,HRV,Johor,196,156,40
2024,HRV,Kedah,53,26,27
2024,HRV,Kelantan,2,2,0
2024,HRV,Perlis,7,4,3
2024,HRV,Pulau Pinang,45,31,14
2024,HRV,Sabah,24,21,3
2024,HRV,Sarawak,10,7,3
2024,HRV,Selangor,1459,875,584
2024,HTI,Johor,7,5,2
2024,HTI,Sabah,2,2,0
2024,HTI,Selangor,78,55,23
2024,HUN,Johor,680,413,267
2024,HUN,Kedah,483,236,247
2024,HUN,Kelantan,6,5,1
2024,HUN,Perak,12,7,5
2024,HUN,Perlis,40,25,15
2024,HUN,Pulau Pinang,229,129,100
2024,HUN,Sabah,108,56,52
2024,HUN,Sarawak,139,69,70
2024,HUN,Selangor,4683,2513,2170
2024,HUN,W.P. Labuan,1,0,1
2024,IDN,Johor,616116,278359,337757
2024,IDN,Kedah,30384,11246,19138
2024,IDN,Kelantan,942,517,425
2024,IDN,Melaka,23459,10520,12939
2024,IDN,Negeri Sembilan,36111,21961,14150
2024,IDN,Pahang,158,93,65
2024,IDN,Perak,1173,362,811
2024,IDN,Perlis,4261,1375,2886
2024,IDN,Pulau Pinang,242934,96373,146561
2024,IDN,Sabah,33158,16419,16739
2024,IDN,Sarawak,282718,146561,136157
2024,IDN,Selangor,916952,424285,492667
2024,IDN,Terengganu,1,1,0
2024,IDN,W.P. Labuan,351,180,171
2024,IND,Johor,221875,141575,80300
2024,IND,Kedah,11213,6270,4943
2024,IND,Kelantan,47,38,9
2024,IND,Melaka,15,13,2
2024,IND,Negeri Sembilan,12,12,0
2024,IND,Pahang,84,70,14
2024,IND,Perak,1397,917,480
2024,IND,Perlis,510,408,102
2024,IND,Pulau Pinang,13643,8499,5144
2024,IND,Sabah,1367,892,475
2024,IND,Sarawak,15220,11937,3283
2024,IND,Selangor,460279,298374,161905
2024,IND,Terengganu,4,2,2
2024,IND,W.P. Labuan,430,337,93
2024,IOT,Selangor,3,1,2
2024,IRL,Johor,1802,1135,667
2024,IRL,Kedah,688,348,340
2024,IRL,Kelantan,10,7,3
2024,IRL,Pahang,3,1,2
2024,IRL,Perak,43,27,16
2024,IRL,Perlis,115,78,37
2024,IRL,Pulau Pinang,976,592,384
2024,IRL,Sabah,175,94,81
2024,IRL,Sarawak,178,95,83
2024,IRL,Selangor,9346,5430,3916
2024,IRL,W.P. Labuan,12,7,5
2024,IRN,Johor,2100,1046,1054
2024,IRN,Kedah,96,37,59
2024,IRN,Kelantan,4,3,1
2024,IRN,Melaka,1,1,0
2024,IRN,Perak,3,2,1
2024,IRN,Perlis,28,22,6
2024,IRN,Pulau Pinang,111,61,50
2024,IRN,Sabah,14,5,9
2024,IRN,Sarawak,22,18,4
2024,IRN,Selangor,14344,7471,6873
2024,IRQ,Johor,212,153,59
2024,IRQ,Kedah,30,17,13
2024,IRQ,Kelantan,2,1,1
2024,IRQ,Perlis,3,3,0
2024,IRQ,Pulau Pinang,33,24,9
2024,IRQ,Sabah,4,3,1
2024,IRQ,Sarawak,25,14,11
2024,IRQ,Selangor,8310,5445,2865
2024,ISL,Johor,22,13,9
2024,ISL,Kedah,20,9,11
2024,ISL,Negeri Sembilan,1,0,1
2024,ISL,Perak,4,2,2
2024,ISL,Perlis,1,0,1
2024,ISL,Pulau Pinang,20,9,11
2024,ISL,Sabah,3,2,1
2024,ISL,Selangor,239,130,109
2024,ISR,Selangor,7,7,0
2024,ITA,Johor,3724,2427,1297
2024,ITA,Kedah,2933,1549,1384
2024,ITA,Kelantan,19,16,3
2024,ITA,Melaka,8,6,2
2024,ITA,Negeri Sembilan,4,4,0
2024,ITA,Pahang,8,8,0
2024,ITA,Perak,59,34,25
2024,ITA,Perlis,187,130,57
2024,ITA,Pulau Pinang,816,584,232
2024,ITA,Sabah,318,199,119
2024,ITA,Sarawak,307,190,117
2024,ITA,Selangor,21809,13705,8104
2024,ITA,Terengganu,2,1,1
2024,ITA,W.P. Labuan,15,10,5
2024,JAM,Johor,39,12,27
2024,JAM,Kedah,7,2,5
2024,JAM,Pulau Pinang,9,4,5
2024,JAM,Sabah,1,0,1
2024,JAM,Sarawak,3,1,2
2024,JAM,Selangor,143,69,74
2024,JOR,Johor,101,68,33
2024,JOR,Kedah,63,39,24
2024,JOR,Kelantan,2,2,0
2024,JOR,Pahang,6,5,1
2024,JOR,Perak,1,0,1
2024,JOR,Perlis,4,3,1
2024,JOR,Pulau Pinang,60,35,25
2024,JOR,Sabah,3,3,0
2024,JOR,Sarawak,7,5,2
2024,JOR,Selangor,5300,3221,2079
2024,JPN,Johor,38316,24858,13458
2024,JPN,Kedah,2490,1265,1225
2024,JPN,Kelantan,66,53,13
2024,JPN,Melaka,5,5,0
2024,JPN,Negeri Sembilan,12,10,2
2024,JPN,Pahang,82,54,28
2024,JPN,Perak,403,249,154
2024,JPN,Perlis,661,493,168
2024,JPN,Pulau Pinang,10179,6542,3637
2024,JPN,Sabah,3051,1531,1520
2024,JPN,Sarawak,1234,735,499
2024,JPN,Selangor,126470,75252,51218
2024,JPN,Terengganu,3,3,0
2024,JPN,W.P. Labuan,91,62,29
2024,KAZ,Johor,312,117,195
2024,KAZ,Kedah,201,82,119
2024,KAZ,Kelantan,11,4,7
2024,KAZ,Perlis,44,18,26
2024,KAZ,Pulau Pinang,71,34,37
2024,KAZ,Sabah,31,14,17
2024,KAZ,Sarawak,58,26,32
2024,KAZ,Selangor,16548,6640,9908
2024,KAZ,W.P. Labuan,2,2,0
2024,KEN,Johor,424,164,260
2024,KEN,Kedah,28,13,15
2024,KEN,Melaka,1,0,1
2024,KEN,Perlis,2,0,2
2024,KEN,Pulau Pinang,75,33,42
2024,KEN,Sabah,8,2,6
2024,KEN,Sarawak,9,8,1
2024,KEN,Selangor,2875,1442,1433
2024,KGZ,Johor,223,155,68
2024,KGZ,Kedah,73,35,38
2024,KGZ,Kelantan,7,6,1
2024,KGZ,Perlis,2,1,1
2024,KGZ,Pulau Pinang,36,13,23
2024,KGZ,Sabah,13,8,5
2024,KGZ,Sarawak,2,2,0
2024,KGZ,Selangor,2756,1249,1507
2024,KHM,Johor,10804,4659,6145
2024,KHM,Kedah,1224,857,367
2024,KHM,Kelantan,4125,3063,1062
2024,KHM,Melaka,4,3,1
2024,KHM,Perak,47,21,26
2024,KHM,Perlis,4822,3090,1732
2024,KHM,Pulau Pinang,224,77,147
2024,KHM,Sabah,10,2,8
2024,KHM,Sarawak,53,29,24
2024,KHM,Selangor,21751,10491,11260
2024,KHM,W.P. Labuan,2,2,0
2024,KIR,Johor,7,2,5
2024,KIR,Selangor,5,3,2
2024,KNA,Johor,129,87,42
2024,KNA,Kedah,19,8,11
2024,KNA,Pulau Pinang,6,6,0
2024,KNA,Sabah,2,0,2
2024,KNA,Sarawak,1,1,0
2024,KNA,Selangor,334,258,76
2024,KOR,Johor,73417,38409,35008
2024,KOR,Kedah,1870,865,1005
2024,KOR,Kelantan,26,16,10
2024,KOR,Melaka,35,18,17
2024,KOR,Negeri Sembilan,16,6,10
2024,KOR,Pahang,12,6,6
2024,KOR,Perak,143,69,74
2024,KOR,Perlis,414,289,125
2024,KOR,Pulau Pinang,4683,2473,2210
2024,KOR,Sabah,94257,38397,55860
2024,KOR,Sarawak,1627,889,738
2024,KOR,Selangor,102567,55119,47448
2024,KOR,W.P. Labuan,56,40,16
2024,KWT,Johor,234,110,124
2024,KWT,Kedah,57,28,29
2024,KWT,Kelantan,2,1,1
2024,KWT,Perlis,2,2,0
2024,KWT,Pulau Pinang,47,30,17
2024,KWT,Sabah,2,2,0
2024,KWT,Sarawak,2,2,0
2024,KWT,Selangor,3374,1922,1452
2024,KWT,W.P. Labuan,1,1,0
2024,LAO,Johor,999,251,748
2024,LAO,Kedah,6562,518,6044
2024,LAO,Kelantan,2328,1504,824
2024,LAO,Perak,201,19,182
2024,LAO,Perlis,2266,461,1805
2024,LAO,Pulau Pinang,185,61,124
2024,LAO,Sabah,2,0,2
2024,LAO,Sarawak,105,59,46
2024,LAO,Selangor,1728,622,1106
2024,LBN,Johor,150,95,55
2024,LBN,Kedah,50,28,22
2024,LBN,Pulau Pinang,43,26,17
2024,LBN,Sabah,12,11,1
2024,LBN,Sarawak,30,29,1
2024,LBN,Selangor,1894,1180,714
2024,LBR,Johor,8,8,0
2024,LBR,Sarawak,2,2,0
2024,LBR,Selangor,39,29,10
2024,LBY,Johor,22,16,6
2024,LBY,Kedah,6,6,0
2024,LBY,Perlis,4,4,0
2024,LBY,Pulau Pinang,3,3,0
2024,LBY,Sabah,2,0,2
2024,LBY,Selangor,1970,1380,590
2024,LCA,Johor,22,14,8
2024,LCA,Kedah,1,1,0
2024,LCA,Pulau Pinang,14,11,3
2024,LCA,Sarawak,5,2,3
2024,LCA,Selangor,76,51,25
2024,LIE,Johor,6,2,4
2024,LIE,Kedah,11,2,9
2024,LIE,Perak,1,1,0
2024,LIE,Pulau Pinang,8,7,1
2024,LIE,Sabah,1,0,1
2024,LIE,Selangor,36,28,8
2024,LKA,Johor,4186,2636,1550
2024,LKA,Kedah,240,150,90
2024,LKA,Kelantan,1,1,0
2024,LKA,Melaka,3,3,0
2024,LKA,Pahang,3,2,1
2024,LKA,Perak,28,18,10
2024,LKA,Perlis,19,13,6
2024,LKA,Pulau Pinang,297,186,111
2024,LKA,Sabah,43,24,19
2024,LKA,Sarawak,166,120,46
2024,LKA,Selangor,26192,16162,10030
2024,LKA,W.P. Labuan,6,5,1
2024,LSO,Johor,1,0,1
2024,LSO,Kedah,1,0,1
2024,LSO,Selangor,42,20,22
2024,LTU,Johor,442,216,226
2024,LTU,Kedah,558,253,305
2024,LTU,Kelantan,1,1,0
2024,LTU,Pahang,2,2,0
2024,LTU,Perak,1,1,0
2024,LTU,Perlis,33,18,15
2024,LTU,Pulau Pinang,101,48,53
2024,LTU,Sabah,63,32,31
2024,LTU,Sarawak,45,21,24
2024,LTU,Selangor,4294,2050,2244
2024,LTU,Terengganu,1,1,0
2024,LTU,W.P. Labuan,49,15,34
2024,LUX,Johor,54,38,16
2024,LUX,Kedah,36,18,18
2024,LUX,Kelantan,2,2,0
2024,LUX,Pahang,2,2,0
2024,LUX,Perlis,4,3,1
2024,LUX,Pulau Pinang,18,12,6
2024,LUX,Sabah,13,8,5
2024,LUX,Sarawak,14,9,5
2024,LUX,Selangor,375,202,173
2024,LVA,Johor,250,110,140
2024,LVA,Kedah,136,60,76
2024,LVA,Perak,3,1,2
2024,LVA,Perlis,12,9,3
2024,LVA,Pulau Pinang,46,26,20
2024,LVA,Sabah,51,14,37
2024,LVA,Sarawak,70,28,42
2024,LVA,Selangor,1511,758,753
2024,LVA,W.P. Labuan,26,11,15
2024,MAC,Johor,2,1,1
2024,MAC,Perak,5,4,1
2024,MAC,Pulau Pinang,3,0,3
2024,MAC,Selangor,23,8,15
2024,MAR,Johor,564,332,232
2024,MAR,Kedah,81,47,34
2024,MAR,Kelantan,9,6,3
2024,MAR,Pahang,1,1,0
2024,MAR,Perlis,10,6,4
2024,MAR,Pulau Pinang,75,42,33
2024,MAR,Sabah,23,9,14
2024,MAR,Sarawak,47,28,19
2024,MAR,Selangor,6574,3609,2965
2024,MCO,Johor,8,7,1
2024,MCO,Kedah,2,1,1
2024,MCO,Perlis,1,0,1
2024,MCO,Pulau Pinang,1,1,0
2024,MCO,Selangor,21,16,5
2024,MDA,Johor,40,14,26
2024,MDA,Kedah,10,3,7
2024,MDA,Kelantan,1,1,0
2024,MDA,Pahang,1,1,0
2024,MDA,Pulau Pinang,1,0,1
2024,MDA,Sabah,4,2,2
2024,MDA,Sarawak,3,1,2
2024,MDA,Selangor,245,110,135
2024,MDG,Johor,85,36,49
2024,MDG,Kedah,2,1,1
2024,MDG,Pulau Pinang,2,1,1
2024,MDG,Sabah,2,0,2
2024,MDG,Sarawak,1,0,1
2024,MDG,Selangor,558,244,314
2024,MDV,Johor,1107,539,568
2024,MDV,Kedah,15,7,8
2024,MDV,Kelantan,2,2,0
2024,MDV,Perak,5,0,5
2024,MDV,Perlis,1,1,0
2024,MDV,Pulau Pinang,40,32,8
2024,MDV,Sabah,8,6,2
2024,MDV,Sarawak,12,6,6
2024,MDV,Selangor,19612,10378,9234
2024,MEX,Johor,1089,522,567
2024,MEX,Kedah,91,48,43
2024,MEX,Kelantan,4,1,3
2024,MEX,Perak,6,5,1
2024,MEX,Perlis,15,10,5
2024,MEX,Pulau Pinang,236,163,73
2024,MEX,Sabah,45,25,20
2024,MEX,Sarawak,15,11,4
2024,MEX,Selangor,4435,2160,2275
2024,MHL,Johor,3,3,0
2024,MHL,Pulau Pinang,2,1,1
2024,MHL,Sabah,1,1,0
2024,MHL,Selangor,20,14,6
2024,MKD,Johor,50,34,16
2024,MKD,Kedah,22,12,10
2024,MKD,Perlis,2,2,0
2024,MKD,Pulau Pinang,7,2,5
2024,MKD,Sabah,1,1,0
2024,MKD,Sarawak,13,7,6
2024,MKD,Selangor,313,150,163
2024,MLI,Johor,4,4,0
2024,MLI,Pulau Pinang,1,0,1
2024,MLI,Sarawak,1,1,0
2024,MLI,Selangor,64,44,20
2024,MLT,Johor,47,22,25
2024,MLT,Kedah,36,22,14
2024,MLT,Perlis,3,1,2
2024,MLT,Pulau Pinang,16,12,4
2024,MLT,Sabah,2,2,0
2024,MLT,Sarawak,4,3,1
2024,MLT,Selangor,322,193,129
2024,MMR,Johor,44019,13201,30818
2024,MMR,Kedah,584,129,455
2024,MMR,Kelantan,22,9,13
2024,MMR,Melaka,2,0,2
2024,MMR,Negeri Sembilan,1,1,0
2024,MMR,Pahang,21,8,13
2024,MMR,Perak,197,37,160
2024,MMR,Perlis,58,9,49
2024,MMR,Pulau Pinang,2201,951,1250
2024,MMR,Sabah,127,40,87
2024,MMR,Sarawak,539,258,281
2024,MMR,Selangor,43061,28544,14517
2024,MMR,W.P. Labuan,10,4,6
2024,MNE,Johor,24,22,2
2024,MNE,Pulau Pinang,6,4,2
2024,MNE,Selangor,106,74,32
2024,MNG,Johor,1611,673,938
2024,MNG,Kedah,77,38,39
2024,MNG,Perak,6,2,4
2024,MNG,Perlis,12,6,6
2024,MNG,Pulau Pinang,79,42,37
2024,MNG,Sabah,34,10,24
2024,MNG,Sarawak,4,2,2
2024,MNG,Selangor,3291,1408,1883
2024,MOZ,Johor,2,0,2
2024,MOZ,Selangor,244,123,121
2024,MRT,Johor,13,11,2
2024,MRT,Kedah,2,1,1
2024,MRT,Sabah,1,1,0
2024,MRT,Selangor,138,105,33
2024,MUS,Johor,1021,516,505
2024,MUS,Kedah,47,28,19
2024,MUS,Kelantan,5,3,2
2024,MUS,Pahang,8,4,4
2024,MUS,Perak,1,0,1
2024,MUS,Perlis,13,9,4
2024,MUS,Pulau Pinang,59,27,32
2024,MUS,Sabah,10,7,3
2024,MUS,Sarawak,5,2,3
2024,MUS,Selangor,8913,4586,4327
2024,MWI,Johor,3,2,1
2024,MWI,Pulau Pinang,8,4,4
2024,MWI,Sabah,1,1,0
2024,MWI,Sarawak,1,0,1
2024,MWI,Selangor,120,76,44
2024,NAM,Johor,9,6,3
2024,NAM,Pulau Pinang,1,1,0
2024,NAM,Selangor,82,45,37
2024,NCL,Selangor,1,1,0
2024,NER,Johor,4,4,0
2024,NER,Selangor,13,8,5
2024,NGA,Johor,140,120,20
2024,NGA,Kedah,6,5,1
2024,NGA,Kelantan,3,2,1
2024,NGA,Pulau Pinang,50,38,12
2024,NGA,Sabah,3,3,0
2024,NGA,Sarawak,57,48,9
2024,NGA,Selangor,2632,2091,541
2024,NIC,Johor,16,10,6
2024,NIC,Kedah,7,2,5
2024,NIC,Pulau Pinang,2,1,1
2024,NIC,Sabah,1,1,0
2024,NIC,Selangor,38,17,21
2024,NLD,Johor,6284,4014,2270
2024,NLD,Kedah,2614,1334,1280
2024,NLD,Kelantan,38,27,11
2024,NLD,Melaka,7,7,0
2024,NLD,Negeri Sembilan,4,2,2
2024,NLD,Pahang,20,13,7
2024,NLD,Perak,102,59,43
2024,NLD,Perlis,305,177,128
2024,NLD,Pulau Pinang,1699,1049,650
2024,NLD,Sabah,513,286,227
2024,NLD,Sarawak,806,509,297
2024,NLD,Selangor,27308,15798,11510
2024,NLD,W.P. Labuan,18,12,6
2024,NOR,Johor,1083,655,428
2024,NOR,Kedah,624,258,366
2024,NOR,Kelantan,3,3,0
2024,NOR,Pahang,1,1,0
2024,NOR,Perak,12,7,5
2024,NOR,Perlis,69,33,36
2024,NOR,Pulau Pinang,290,175,115
2024,NOR,Sabah,73,44,29
2024,NOR,Sarawak,120,86,34
2024,NOR,Selangor,5421,3081,2340
2024,NOR,W.P. Labuan,2,2,0
2024,NPL,Johor,5709,4117,1592
2024,NPL,Kedah,137,90,47
2024,NPL,Kelantan,1,1,0
2024,NPL,Perak,6,4,2
2024,NPL,Perlis,15,15,0
2024,NPL,Pulau Pinang,189,162,27
2024,NPL,Sabah,18,9,9
2024,NPL,Sarawak,1405,959,446
2024,NPL,Selangor,61539,58022,3517
2024,NPL,W.P. Labuan,438,408,30
2024,NRU,Selangor,12,10,2
2024,NZL,Johor,5116,3036,2080
2024,NZL,Kedah,726,392,334
2024,NZL,Kelantan,16,9,7
2024,NZL,Melaka,6,1,5
2024,NZL,Negeri Sembilan,1,1,0
2024,NZL,Pahang,23,15,8
2024,NZL,Perak,137,81,56
2024,NZL,Perlis,122,67,55
2024,NZL,Pulau Pinang,1484,788,696
2024,NZL,Sabah,403,208,195
2024,NZL,Sarawak,800,464,336
2024,NZL,Selangor,18102,10672,7430
2024,NZL,Terengganu,4,2,2
2024,NZL,W.P. Labuan,19,11,8
2024,OMN,Johor,185,128,57
2024,OMN,Kedah,48,29,19
2024,OMN,Kelantan,1,1,0
2024,OMN,Perak,7,5,2
2024,OMN,Perlis,15,8,7
2024,OMN,Pulau Pinang,70,61,9
2024,OMN,Sabah,3,2,1
2024,OMN,Sarawak,64,45,19
2024,OMN,Selangor,8800,4979,3821
2024,PAK,Johor,3917,2933,984
2024,PAK,Kedah,715,520,195
2024,PAK,Kelantan,105,102,3
2024,PAK,Melaka,1,1,0
2024,PAK,Pahang,4,4,0
2024,PAK,Perak,23,20,3
2024,PAK,Perlis,114,106,8
2024,PAK,Pulau Pinang,723,612,111
2024,PAK,Sabah,97,79,18
2024,PAK,Sarawak,994,830,164
2024,PAK,Selangor,60833,50541,10292
2024,PAK,W.P. Labuan,17,14,3
2024,PAN,Johor,52,28,24
2024,PAN,Kedah,7,4,3
2024,PAN,Pulau Pinang,8,6,2
2024,PAN,Sabah,5,0,5
2024,PAN,Sarawak,3,2,1
2024,PAN,Selangor,172,78,94
2024,PER,Johor,183,100,83
2024,PER,Kedah,38,21,17
2024,PER,Kelantan,2,1,1
2024,PER,Perak,3,1,2
2024,PER,Perlis,10,7,3
2024,PER,Pulau Pinang,27,19,8
2024,PER,Sabah,5,2,3
2024,PER,Sarawak,7,5,2
2024,PER,Selangor,904,475,429
2024,PHL,Johor,152491,47529,104962
2024,PHL,Kedah,2983,907,2076
2024,PHL,Kelantan,274,131,143
2024,PHL,Melaka,4,1,3
2024,PHL,Negeri Sembilan,12,11,1
2024,PHL,Pahang,115,84,31
2024,PHL,Perak,479,163,316
2024,PHL,Perlis,1260,418,842
2024,PHL,Pulau Pinang,5788,2352,3436
2024,PHL,Sabah,10242,4496,5746
2024,PHL,Sarawak,18263,7441,10822
2024,PHL,Selangor,105231,41377,63854
2024,PHL,Terengganu,2,0,2
2024,PHL,W.P. Labuan,731,257,474
2024,PLW,Johor,5,5,0
2024,PLW,Pulau Pinang,1,1,0
2024,PLW,Selangor,12,9,3
2024,PNG,Johor,121,36,85
2024,PNG,Kedah,1,1,0
2024,PNG,Perak,4,3,1
2024,PNG,Pulau Pinang,5,1,4
2024,PNG,Sabah,5,3,2
2024,PNG,Sarawak,40,22,18
2024,PNG,Selangor,541,301,240
2024,POL,Johor,3184,1751,1433
2024,POL,Kedah,1819,907,912
2024,POL,Kelantan,19,12,7
2024,POL,Melaka,3,3,0
2024,POL,Pahang,5,3,2
2024,POL,Perak,21,11,10
2024,POL,Perlis,171,98,73
2024,POL,Pulau Pinang,562,280,282
2024,POL,Sabah,335,160,175
2024,POL,Sarawak,335,180,155
2024,POL,Selangor,12748,6595,6153
2024,POL,W.P. Labuan,31,17,14
2024,PRI,Sabah,1,0,1
2024,PRT,Johor,1165,657,508
2024,PRT,Kedah,529,265,264
2024,PRT,Kelantan,3,2,1
2024,PRT,Melaka,3,2,1
2024,PRT,Pahang,4,3,1
2024,PRT,Perak,8,5,3
2024,PRT,Perlis,31,18,13
2024,PRT,Pulau Pinang,274,145,129
2024,PRT,Sabah,199,109,90
2024,PRT,Sarawak,66,42,24
2024,PRT,Selangor,5343,3024,2319
2024,PRT,W.P. Labuan,3,1,2
2024,PRY,Johor,23,10,13
2024,PRY,Kedah,4,0,4
2024,PRY,Perlis,2,1,1
2024,PRY,Pulau Pinang,4,1,3
2024,PRY,Sabah,6,4,2
2024,PRY,Selangor,90,44,46
2024,PSE,Johor,128,114,14
2024,PSE,Kedah,24,16,8
2024,PSE,Perak,1,1,0
2024,PSE,Pulau Pinang,14,13,1
2024,PSE,Sabah,1,1,0
2024,PSE,Sarawak,3,3,0
2024,PSE,Selangor,1809,1226,583
2024,QAT,Johor,39,22,17
2024,QAT,Kedah,10,5,5
2024,QAT,Perlis,2,2,0
2024,QAT,Pulau Pinang,6,4,2
2024,QAT,Sarawak,4,3,1
2024,QAT,Selangor,946,627,319
2024,ROU,Johor,956,544,412
2024,ROU,Kedah,459,217,242
2024,ROU,Kelantan,6,4,2
2024,ROU,Melaka,1,1,0
2024,ROU,Pahang,3,3,0
2024,ROU,Perak,9,4,5
2024,ROU,Perlis,20,13,7
2024,ROU,Pulau Pinang,213,108,105
2024,ROU,Sabah,66,39,27
2024,ROU,Sarawak,45,32,13
2024,ROU,Selangor,5629,2882,2747
2024,RUS,Johor,2731,1337,1394
2024,RUS,Kedah,3008,1437,1571
2024,RUS,Kelantan,184,96,88
2024,RUS,Melaka,5,4,1
2024,RUS,Pahang,11,3,8
2024,RUS,Perak,39,20,19
2024,RUS,Perlis,488,300,188
2024,RUS,Pulau Pinang,1001,504,497
2024,RUS,Sabah,470,228,242
2024,RUS,Sarawak,315,165,150
2024,RUS,Selangor,64355,31030,33325
2024,RUS,W.P. Labuan,45,19,26
2024,RWA,Johor,7,2,5
2024,RWA,Pulau Pinang,1,1,0
2024,RWA,Selangor,50,32,18
2024,SAU,Johor,1209,664,545
2024,SAU,Kedah,308,174,134
2024,SAU,Kelantan,16,13,3
2024,SAU,Perak,14,10,4
2024,SAU,Perlis,15,9,6
2024,SAU,Pulau Pinang,264,140,124
2024,SAU,Sabah,12,8,4
2024,SAU,Sarawak,87,51,36
2024,SAU,Selangor,28525,16209,12316
2024,SDN,Johor,76,56,20
2024,SDN,Kedah,25,13,12
2024,SDN,Kelantan,2,2,0
2024,SDN,Perlis,1,1,0
2024,SDN,Pulau Pinang,27,11,16
2024,SDN,Sabah,2,2,0
2024,SDN,Sarawak,36,20,16
2024,SDN,Selangor,6529,3777,2752
2024,SDN,W.P. Labuan,6,6,0
2024,SEN,Johor,45,37,8
2024,SEN,Kedah,1,1,0
2024,SEN,Perlis,1,1,0
2024,SEN,Pulau Pinang,1,0,1
2024,SEN,Sabah,2,2,0
2024,SEN,Selangor,400,277,123
2024,SGP,Johor,7891792,4472748,3419044
2024,SGP,Kedah,28167,14723,13444
2024,SGP,Kelantan,637,383,254
2024,SGP,Melaka,175,126,49
2024,SGP,Negeri Sembilan,19,11,8
2024,SGP,Pahang,3575,1825,1750
2024,SGP,Perak,37529,17573,19956
2024,SGP,Perlis,1584,948,636
2024,SGP,Pulau Pinang,124475,61079,63396
2024,SGP,Sabah,15568,7877,7691
2024,SGP,Sarawak,24840,13730,11110
2024,SGP,Selangor,298031,153580,144451
2024,SGP,W.P. Labuan,59,49,10
2024,SHN,Johor,1,1,0
2024,SLB,Johor,20,13,7
2024,SLB,Pulau Pinang,9,5,4
2024,SLB,Sarawak,50,9,41
2024,SLB,Selangor,53,30,23
2024,SLE,Johor,22,14,8
2024,SLE,Kedah,5,4,1
2024,SLE,Kelantan,1,1,0
2024,SLE,Pulau Pinang,5,1,4
2024,SLE,Selangor,132,84,48
2024,SLV,Johor,14,10,4
2024,SLV,Kedah,16,5,11
2024,SLV,Pulau Pinang,3,2,1
2024,SLV,Sabah,1,0,1
2024,SLV,Sarawak,2,2,0
2024,SLV,Selangor,95,52,43
2024,SMR,Kedah,2,1,1
2024,SMR,Selangor,25,19,6
2024,SOM,Johor,4,4,0
2024,SOM,Kedah,1,1,0
2024,SOM,Kelantan,3,1,2
2024,SOM,Pulau Pinang,5,1,4
2024,SOM,Selangor,1369,766,603
2024,SPM,Johor,1,0,1
2024,SRB,Johor,62,47,15
2024,SRB,Kedah,34,15,19
2024,SRB,Pahang,1,1,0
2024,SRB,Perak,2,2,0
2024,SRB,Perlis,3,1,2
2024,SRB,Pulau Pinang,29,24,5
2024,SRB,Sabah,4,2,2
2024,SRB,Sarawak,6,2,4
2024,SRB,Selangor,854,417,437
2024,SSD,Johor,1,1,0
2024,SSD,Kedah,1,1,0
2024,SSD,Pulau Pinang,2,0,2
2024,SSD,Sabah,1,1,0
2024,SSD,Sarawak,15,7,8
2024,SSD,Selangor,204,122,82
2024,SSD,W.P. Labuan,3,1,2
2024,STP,Selangor,5,1,4
2024,SUR,Johor,14,10,4
2024,SUR,Kedah,4,1,3
2024,SUR,Pulau Pinang,9,7,2
2024,SUR,Sabah,2,2,0
2024,SUR,Selangor,105,69,36
2024,SVK,Johor,314,180,134
2024,SVK,Kedah,710,363,347
2024,SVK,Kelantan,5,4,1
2024,SVK,Pahang,1,0,1
2024,SVK,Perak,4,3,1
2024,SVK,Perlis,12,7,5
2024,SVK,Pulau Pinang,139,85,54
2024,SVK,Sabah,44,20,24
2024,SVK,Sarawak,31,20,11
2024,SVK,Selangor,2739,1465,1274
2024,SVK,W.P. Labuan,13,9,4
2024,SVN,Johor,135,70,65
2024,SVN,Kedah,232,119,113
2024,SVN,Perak,3,2,1
2024,SVN,Perlis,11,6,5
2024,SVN,Pulau Pinang,25,13,12
2024,SVN,Sabah,16,8,8
2024,SVN,Sarawak,9,1,8
2024,SVN,Selangor,1502,801,701
2024,SVN,W.P. Labuan,2,1,1
2024,SWE,Johor,1683,966,717
2024,SWE,Kedah,1772,805,967
2024,SWE,Kelantan,41,29,12
2024,SWE,Melaka,1,0,1
2024,SWE,Pahang,2,2,0
2024,SWE,Perak,28,18,10
2024,SWE,Perlis,102,74,28
2024,SWE,Pulau Pinang,616,404,212
2024,SWE,Sabah,164,92,72
2024,SWE,Sarawak,118,80,38
2024,SWE,Selangor,8151,4692,3459
2024,SWE,W.P. Labuan,10,6,4
2024,SWZ,Johor,10,7,3
2024,SWZ,Pulau Pinang,1,1,0
2024,SWZ,Selangor,151,68,83
2024,SYC,Johor,49,16,33
2024,SYC,Pahang,1,1,0
2024,SYC,Pulau Pinang,3,3,0
2024,SYC,Selangor,579,232,347
2024,SYR,Johor,140,106,34
2024,SYR,Kedah,83,43,40
2024,SYR,Kelantan,1,0,1
2024,SYR,Pahang,7,7,0
2024,SYR,Perlis,1,1,0
2024,SYR,Pulau Pinang,46,36,10
2024,SYR,Sabah,12,9,3
2024,SYR,Sarawak,27,23,4
2024,SYR,Selangor,3950,2479,1471
2024,TCA,Selangor,1,0,1
2024,TCD,Johor,32,26,6
2024,TCD,Pulau Pinang,1,1,0
2024,TCD,Selangor,170,133,37
2024,TGO,Johor,4,4,0
2024,TGO,Kedah,1,1,0
2024,TGO,Pulau Pinang,1,1,0
2024,TGO,Sabah,1,1,0
2024,TGO,Sarawak,1,0,1
2024,TGO,Selangor,49,36,13
2024,THA,Johor,45043,12173,32870
2024,THA,Kedah,366108,211827,154281
2024,THA,Kelantan,325996,163264,162732
2024,THA,Melaka,11,6,5
2024,THA,Negeri Sembilan,3,2,1
2024,THA,Pahang,72,49,23
2024,THA,Perak,64945,30243,34702
2024,THA,Perlis,308729,178917,129812
2024,THA,Pulau Pinang,16780,6393,10387
2024,THA,Sabah,213,67,146
2024,THA,Sarawak,2666,878,1788
2024,THA,Selangor,84229,31977,52252
2024,THA,Terengganu,3,3,0
2024,THA,W.P. Labuan,63,29,34
2024,TJK,Johor,12,8,4
2024,TJK,Kedah,9,6,3
2024,TJK,Pulau Pinang,2,2,0
2024,TJK,Sabah,14,11,3
2024,TJK,Selangor,980,666,314
2024,TKM,Johor,27,16,11
2024,TKM,Kedah,15,5,10
2024,TKM,Kelantan,1,1,0
2024,TKM,Pulau Pinang,5,5,0
2024,TKM,Sabah,4,3,1
2024,TKM,Sarawak,4,4,0
2024,TKM,Selangor,3052,1574,1478
2024,TLS,Johor,68,38,30
2024,TLS,Kedah,7,1,6
2024,TLS,Perak,9,2,7
2024,TLS,Pulau Pinang,36,16,20
2024,TLS,Sabah,3,0,3
2024,TLS,Sarawak,14,12,2
2024,TLS,Selangor,1398,746,652
2024,TON,Johor,16,11,5
2024,TON,Kedah,2,1,1
2024,TON,Pulau Pinang,9,1,8
2024,TON,Sabah,1,0,1
2024,TON,Sarawak,1,1,0
2024,TON,Selangor,105,57,48
2024,TTO,Johor,30,17,13
2024,TTO,Kedah,5,1,4
2024,TTO,Perak,1,1,0
2024,TTO,Pulau Pinang,6,3,3
2024,TTO,Sabah,3,1,2
2024,TTO,Sarawak,7,1,6
2024,TTO,Selangor,193,104,89
2024,TTO,W.P. Labuan,1,1,0
2024,TUN,Johor,107,61,46
2024,TUN,Kedah,34,20,14
2024,TUN,Kelantan,3,3,0
2024,TUN,Melaka,2,0,2
2024,TUN,Perlis,2,0,2
2024,TUN,Pulau Pinang,50,27,23
2024,TUN,Sabah,7,5,2
2024,TUN,Sarawak,5,5,0
2024,TUN,Selangor,3835,2063,1772
2024,TUR,Johor,2041,1401,640
2024,TUR,Kedah,402,250,152
2024,TUR,Kelantan,34,28,6
2024,TUR,Melaka,4,4,0
2024,TUR,Pahang,5,4,1
2024,TUR,Perak,17,12,5
2024,TUR,Perlis,116,91,25
2024,TUR,Pulau Pinang,246,183,63
2024,TUR,Sabah,33,23,10
2024,TUR,Sarawak,155,113,42
2024,TUR,Selangor,12140,8045,4095
2024,TUR,Terengganu,1,1,0
2024,TUR,W.P. Labuan,1,0,1
2024,TUV,Johor,1,1,0
2024,TUV,Pulau Pinang,2,0,2
2024,TUV,Selangor,6,3,3
2024,TWN,Johor,47305,20294,27011
2024,TWN,Kedah,1417,672,745
2024,TWN,Kelantan,24,17,7
2024,TWN,Melaka,32,20,12
2024,TWN,Negeri Sembilan,6,3,3
2024,TWN,Pahang,32,22,10
2024,TWN,Perak,442,201,241
2024,TWN,Perlis,218,117,101
2024,TWN,Pulau Pinang,25663,12323,13340
2024,TWN,Sabah,14191,6563,7628
2024,TWN,Sarawak,2358,974,1384
2024,TWN,Selangor,106363,50347,56016
2024,TWN,W.P. Labuan,13,9,4
2024,TZA,Johor,159,74,85
2024,TZA,Kedah,4,1,3
2024,TZA,Perak,1,1,0
2024,TZA,Pulau Pinang,8,4,4
2024,TZA,Sabah,3,3,0
2024,TZA,Sarawak,11,10,1
2024,TZA,Selangor,1153,577,576
2024,UGA,Johor,452,207,245
2024,UGA,Kedah,7,2,5
2024,UGA,Pahang,2,1,1
2024,UGA,Perlis,2,1,1
2024,UGA,Pulau Pinang,14,8,6
2024,UGA,Sabah,3,2,1
2024,UGA,Sarawak,11,6,5
2024,UGA,Selangor,1039,420,619
2024,UKR,Johor,687,312,375
2024,UKR,Kedah,298,130,168
2024,UKR,Kelantan,89,39,50
2024,UKR,Pahang,10,8,2
2024,UKR,Perak,5,3,2
2024,UKR,Perlis,55,25,30
2024,UKR,Pulau Pinang,210,97,113
2024,UKR,Sabah,57,27,30
2024,UKR,Sarawak,15,10,5
2024,UKR,Selangor,7672,3538,4134
2024,UKR,W.P. Labuan,2,1,1
2024,URY,Johor,196,82,114
2024,URY,Kedah,24,13,11
2024,URY,Perlis,1,0,1
2024,URY,Pulau Pinang,3,1,2
2024,URY,Sabah,2,1,1
2024,URY,Sarawak,1,0,1
2024,URY,Selangor,403,182,221
2024,USA,Johor,30509,17284,13225
2024,USA,Kedah,4302,2239,2063
2024,USA,Kelantan,119,77,42
2024,USA,Melaka,22,15,7
2024,USA,Negeri Sembilan,6,5,1
2024,USA,Pahang,60,44,16
2024,USA,Perak,814,468,346
2024,USA,Perlis,777,510,267
2024,USA,Pulau Pinang,15815,9171,6644
2024,USA,Sabah,2947,1662,1285
2024,USA,Sarawak,1908,1068,840
2024,USA,Selangor,98728,56799,41929
2024,USA,Terengganu,7,4,3
2024,USA,W.P. Labuan,32,21,11
2024,UZB,Johor,505,383,122
2024,UZB,Kedah,139,80,59
2024,UZB,Kelantan,12,10,2
2024,UZB,Perak,1,1,0
2024,UZB,Perlis,5,3,2
2024,UZB,Pulau Pinang,35,26,9
2024,UZB,Sabah,30,18,12
2024,UZB,Sarawak,3,0,3
2024,UZB,Selangor,9403,5741,3662
2024,VAT,Johor,3,3,0
2024,VAT,Pulau Pinang,1,1,0
2024,VAT,Selangor,4,3,1
2024,VCT,Johor,2,2,0
2024,VCT,Pulau Pinang,1,1,0
2024,VCT,Sabah,1,1,0
2024,VCT,Selangor,14,12,2
2024,VEN,Johor,98,52,46
2024,VEN,Kedah,16,11,5
2024,VEN,Kelantan,1,0,1
2024,VEN,Perlis,1,0,1
2024,VEN,Pulau Pinang,11,8,3
2024,VEN,Sabah,7,2,5
2024,VEN,Sarawak,18,10,8
2024,VEN,Selangor,579,314,265
2024,VNM,Johor,87902,27592,60310
2024,VNM,Kedah,2040,280,1760
2024,VNM,Kelantan,90,43,47
2024,VNM,Melaka,4,2,2
2024,VNM,Pahang,15,10,5
2024,VNM,Perak,891,65,826
2024,VNM,Perlis,1380,112,1268
2024,VNM,Pulau Pinang,8627,2445,6182
2024,VNM,Sabah,190,56,134
2024,VNM,Sarawak,2172,370,1802
2024,VNM,Selangor,99364,34249,65115
2024,VNM,Terengganu,14,14,0
2024,VNM,W.P. Labuan,21,12,9
2024,VUT,Johor,194,148,46
2024,VUT,Kedah,4,4,0
2024,VUT,Perlis,2,2,0
2024,VUT,Pulau Pinang,33,27,6
2024,VUT,Sabah,11,9,2
2024,VUT,Sarawak,1,1,0
2024,VUT,Selangor,575,501,74
2024,WSM,Johor,1,0,1
2024,WSM,Pulau Pinang,1,0,1
2024,WSM,Sarawak,1,0,1
2024,WSM,Selangor,12,4,8
2024,XXX,Johor,18,13,5
2024,XXX,Kedah,2,0,2
2024,XXX,Perlis,1,1,0
2024,XXX,Pulau Pinang,5,4,1
2024,XXX,Sabah,3,2,1
2024,XXX,Sarawak,4,3,1
2024,XXX,Selangor,390,235,155
2024,YEM,Johor,219,160,59
2024,YEM,Kedah,37,27,10
2024,YEM,Kelantan,7,5,2
2024,YEM,Melaka,12,8,4
2024,YEM,Perak,1,1,0
2024,YEM,Perlis,10,10,0
2024,YEM,Pulau Pinang,38,26,12
2024,YEM,Sabah,5,4,1
2024,YEM,Sarawak,26,21,5
2024,YEM,Selangor,7642,5189,2453
2024,ZAF,Johor,1758,1056,702
2024,ZAF,Kedah,305,165,140
2024,ZAF,Kelantan,6,4,2
2024,ZAF,Pahang,10,6,4
2024,ZAF,Perak,12,9,3
2024,ZAF,Perlis,73,41,32
2024,ZAF,Pulau Pinang,456,239,217
2024,ZAF,Sabah,167,89,78
2024,ZAF,Sarawak,616,270,346
2024,ZAF,Selangor,6514,3615,2899
2024,ZAF,Terengganu,1,1,0
2024,ZAF,W.P. Labuan,77,33,44
2024,ZAR,Pulau Pinang,1,0,1
2024,ZAR,Selangor,15,8,7
2024,ZMB,Johor,31,19,12
2024,ZMB,Kedah,4,2,2
2024,ZMB,Perak,1,0,1
2024,ZMB,Pulau Pinang,11,3,8
2024,ZMB,Sarawak,2,1,1
2024,ZMB,Selangor,374,189,185
2024,ZWE,Johor,103,41,62
2024,ZWE,Kedah,8,3,5
2024,ZWE,Kelantan,1,0,1
2024,ZWE,Pulau Pinang,25,10,15
2024,ZWE,Sabah,2,1,1
2024,ZWE,Sarawak,1,0,1
2024,ZWE,Selangor,913,452,461
